"_id",Geo_FIPS,Geo_GEOID,Geo_NAME,Geo_QName,total_sex_pop,male_pop,female_pop
5ea728146307ba36aa1df531,1001,05000US01001,Autauga County,"Autauga County, Alabama",55200,26874,28326
5ea728146307ba36aa1df532,1003,05000US01003,Baldwin County,"Baldwin County, Alabama",208107,101188,106919
5ea728146307ba36aa1df533,1005,05000US01005,Barbour County,"Barbour County, Alabama",25782,13697,12085
5ea728146307ba36aa1df534,1007,05000US01007,Bibb County,"Bibb County, Alabama",22527,12152,10375
5ea728146307ba36aa1df535,1009,05000US01009,Blount County,"Blount County, Alabama",57645,28434,29211
5ea728146307ba36aa1df536,1011,05000US01011,Bullock County,"Bullock County, Alabama",10352,5663,4689
5ea728146307ba36aa1df537,1013,05000US01013,Butler County,"Butler County, Alabama",20025,9368,10657
5ea728146307ba36aa1df538,1015,05000US01015,Calhoun County,"Calhoun County, Alabama",115098,55315,59783
5ea728146307ba36aa1df539,1017,05000US01017,Chambers County,"Chambers County, Alabama",33826,16257,17569
5ea728146307ba36aa1df53a,1019,05000US01019,Cherokee County,"Cherokee County, Alabama",25853,12820,13033
5ea728146307ba36aa1df53b,1021,05000US01021,Chilton County,"Chilton County, Alabama",43930,21672,22258
5ea728146307ba36aa1df53c,1023,05000US01023,Choctaw County,"Choctaw County, Alabama",13075,6253,6822
5ea728146307ba36aa1df53d,1025,05000US01025,Clarke County,"Clarke County, Alabama",24387,11539,12848
5ea728146307ba36aa1df53e,1027,05000US01027,Clay County,"Clay County, Alabama",13378,6464,6914
5ea728146307ba36aa1df53f,1029,05000US01029,Cleburne County,"Cleburne County, Alabama",14938,7281,7657
5ea728146307ba36aa1df540,1031,05000US01031,Coffee County,"Coffee County, Alabama",51288,25314,25974
5ea728146307ba36aa1df541,1033,05000US01033,Colbert County,"Colbert County, Alabama",54495,26075,28420
5ea728146307ba36aa1df542,1035,05000US01035,Conecuh County,"Conecuh County, Alabama",12514,6037,6477
5ea728146307ba36aa1df543,1037,05000US01037,Coosa County,"Coosa County, Alabama",10855,5501,5354
5ea728146307ba36aa1df544,1039,05000US01039,Covington County,"Covington County, Alabama",37351,18172,19179
5ea728146307ba36aa1df545,1041,05000US01041,Crenshaw County,"Crenshaw County, Alabama",13865,6814,7051
5ea728146307ba36aa1df546,1043,05000US01043,Cullman County,"Cullman County, Alabama",82313,40560,41753
5ea728146307ba36aa1df547,1045,05000US01045,Dale County,"Dale County, Alabama",49255,24234,25021
5ea728146307ba36aa1df548,1047,05000US01047,Dallas County,"Dallas County, Alabama",40029,18448,21581
5ea728146307ba36aa1df549,1049,05000US01049,DeKalb County,"DeKalb County, Alabama",71200,35304,35896
5ea728146307ba36aa1df54a,1051,05000US01051,Elmore County,"Elmore County, Alabama",81212,39450,41762
5ea728146307ba36aa1df54b,1053,05000US01053,Escambia County,"Escambia County, Alabama",37328,19067,18261
5ea728146307ba36aa1df54c,1055,05000US01055,Etowah County,"Etowah County, Alabama",102939,49651,53288
5ea728146307ba36aa1df54d,1057,05000US01057,Fayette County,"Fayette County, Alabama",16585,8170,8415
5ea728146307ba36aa1df54e,1059,05000US01059,Franklin County,"Franklin County, Alabama",31542,15602,15940
5ea728146307ba36aa1df54f,1061,05000US01061,Geneva County,"Geneva County, Alabama",26491,12971,13520
5ea728146307ba36aa1df550,1063,05000US01063,Greene County,"Greene County, Alabama",8426,3950,4476
5ea728146307ba36aa1df551,1065,05000US01065,Hale County,"Hale County, Alabama",14887,7019,7868
5ea728146307ba36aa1df552,1067,05000US01067,Henry County,"Henry County, Alabama",17124,8232,8892
5ea728146307ba36aa1df553,1069,05000US01069,Houston County,"Houston County, Alabama",104352,50029,54323
5ea728146307ba36aa1df554,1071,05000US01071,Jackson County,"Jackson County, Alabama",52094,25536,26558
5ea728146307ba36aa1df555,1073,05000US01073,Jefferson County,"Jefferson County, Alabama",659892,312348,347544
5ea728146307ba36aa1df556,1075,05000US01075,Lamar County,"Lamar County, Alabama",13933,6800,7133
5ea728146307ba36aa1df557,1077,05000US01077,Lauderdale County,"Lauderdale County, Alabama",92585,44315,48270
5ea728146307ba36aa1df558,1079,05000US01079,Lawrence County,"Lawrence County, Alabama",33171,16003,17168
5ea728146307ba36aa1df559,1081,05000US01081,Lee County,"Lee County, Alabama",159287,78372,80915
5ea728146307ba36aa1df55a,1083,05000US01083,Limestone County,"Limestone County, Alabama",93052,46427,46625
5ea728146307ba36aa1df55b,1085,05000US01085,Lowndes County,"Lowndes County, Alabama",10236,4830,5406
5ea728146307ba36aa1df55c,1087,05000US01087,Macon County,"Macon County, Alabama",19054,8790,10264
5ea728146307ba36aa1df55d,1089,05000US01089,Madison County,"Madison County, Alabama",357560,174665,182895
5ea728146307ba36aa1df55e,1091,05000US01091,Marengo County,"Marengo County, Alabama",19538,9446,10092
5ea728146307ba36aa1df55f,1093,05000US01093,Marion County,"Marion County, Alabama",29965,14898,15067
5ea728146307ba36aa1df560,1095,05000US01095,Marshall County,"Marshall County, Alabama",95145,46977,48168
5ea728146307ba36aa1df561,1097,05000US01097,Mobile County,"Mobile County, Alabama",414659,197928,216731
5ea728146307ba36aa1df562,1099,05000US01099,Monroe County,"Monroe County, Alabama",21512,10230,11282
5ea728146307ba36aa1df563,1101,05000US01101,Montgomery County,"Montgomery County, Alabama",226941,107354,119587
5ea728146307ba36aa1df564,1103,05000US01103,Morgan County,"Morgan County, Alabama",119122,58660,60462
5ea728146307ba36aa1df565,1105,05000US01105,Perry County,"Perry County, Alabama",9486,4436,5050
5ea728146307ba36aa1df566,1107,05000US01107,Pickens County,"Pickens County, Alabama",20298,9708,10590
5ea728146307ba36aa1df567,1109,05000US01109,Pike County,"Pike County, Alabama",33403,16027,17376
5ea728146307ba36aa1df568,1111,05000US01111,Randolph County,"Randolph County, Alabama",22574,10989,11585
5ea728146307ba36aa1df569,1113,05000US01113,Russell County,"Russell County, Alabama",58213,28124,30089
5ea728146307ba36aa1df56a,1115,05000US01115,St. Clair County,"St. Clair County, Alabama",87306,43755,43551
5ea728146307ba36aa1df56b,1117,05000US01117,Shelby County,"Shelby County, Alabama",211261,102478,108783
5ea728146307ba36aa1df56c,1119,05000US01119,Sumter County,"Sumter County, Alabama",12985,6014,6971
5ea728146307ba36aa1df56d,1121,05000US01121,Talladega County,"Talladega County, Alabama",80565,39156,41409
5ea728146307ba36aa1df56e,1123,05000US01123,Tallapoosa County,"Tallapoosa County, Alabama",40636,19517,21119
5ea728146307ba36aa1df56f,1125,05000US01125,Tuscaloosa County,"Tuscaloosa County, Alabama",206213,99539,106674
5ea728146307ba36aa1df570,1127,05000US01127,Walker County,"Walker County, Alabama",64493,31506,32987
5ea728146307ba36aa1df571,1129,05000US01129,Washington County,"Washington County, Alabama",16643,8420,8223
5ea728146307ba36aa1df572,1131,05000US01131,Wilcox County,"Wilcox County, Alabama",10809,5134,5675
5ea728146307ba36aa1df573,1133,05000US01133,Winston County,"Winston County, Alabama",23875,11840,12035
5ea728146307ba36aa1df574,2013,05000US02013,Aleutians East Borough,"Aleutians East Borough, Alaska",3425,1989,1436
5ea728146307ba36aa1df575,2016,05000US02016,Aleutians West Census Area,"Aleutians West Census Area, Alaska",5750,3432,2318
5ea728146307ba36aa1df576,2020,05000US02020,Anchorage Municipality,"Anchorage Municipality, Alaska",296112,151144,144968
5ea728146307ba36aa1df577,2050,05000US02050,Bethel Census Area,"Bethel Census Area, Alaska",18040,9381,8659
5ea728146307ba36aa1df578,2060,05000US02060,Bristol Bay Borough,"Bristol Bay Borough, Alaska",890,526,364
5ea728146307ba36aa1df579,2068,05000US02068,Denali Borough,"Denali Borough, Alaska",2232,1117,1115
5ea728146307ba36aa1df57a,2070,05000US02070,Dillingham Census Area,"Dillingham Census Area, Alaska",4975,2573,2402
5ea728146307ba36aa1df57b,2090,05000US02090,Fairbanks North Star Borough,"Fairbanks North Star Borough, Alaska",99653,53846,45807
5ea728146307ba36aa1df57c,2100,05000US02100,Haines Borough,"Haines Borough, Alaska",2518,1335,1183
5ea728146307ba36aa1df57d,2105,05000US02105,Hoonah-Angoon Census Area,"Hoonah-Angoon Census Area, Alaska",2132,1095,1037
5ea728146307ba36aa1df57e,2110,05000US02110,Juneau City and Borough,"Juneau City and Borough, Alaska",32330,16517,15813
5ea728146307ba36aa1df57f,2122,05000US02122,Kenai Peninsula Borough,"Kenai Peninsula Borough, Alaska",58220,30314,27906
5ea728146307ba36aa1df580,2130,05000US02130,Ketchikan Gateway Borough,"Ketchikan Gateway Borough, Alaska",13804,7060,6744
5ea728146307ba36aa1df581,2150,05000US02150,Kodiak Island Borough,"Kodiak Island Borough, Alaska",13649,7281,6368
5ea728146307ba36aa1df582,2158,05000US02158,Kusilvak Census Area,"Kusilvak Census Area, Alaska",8198,4388,3810
5ea728146307ba36aa1df583,2164,05000US02164,Lake and Peninsula Borough,"Lake and Peninsula Borough, Alaska",1375,710,665
5ea728146307ba36aa1df584,2170,05000US02170,Matanuska-Susitna Borough,"Matanuska-Susitna Borough, Alaska",103464,53912,49552
5ea728146307ba36aa1df585,2180,05000US02180,Nome Census Area,"Nome Census Area, Alaska",9925,5240,4685
5ea728146307ba36aa1df586,2185,05000US02185,North Slope Borough,"North Slope Borough, Alaska",9797,6116,3681
5ea728146307ba36aa1df587,2188,05000US02188,Northwest Arctic Borough,"Northwest Arctic Borough, Alaska",7734,4156,3578
5ea728146307ba36aa1df588,2195,05000US02195,Petersburg Borough,"Petersburg Borough, Alaska",3255,1649,1606
5ea728146307ba36aa1df589,2198,05000US02198,Prince of Wales-Hyder Census Area,"Prince of Wales-Hyder Census Area, Alaska",6474,3514,2960
5ea728146307ba36aa1df58a,2220,05000US02220,Sitka City and Borough,"Sitka City and Borough, Alaska",8738,4471,4267
5ea728146307ba36aa1df58b,2230,05000US02230,Skagway Municipality,"Skagway Municipality, Alaska",1061,555,506
5ea728146307ba36aa1df58c,2240,05000US02240,Southeast Fairbanks Census Area,"Southeast Fairbanks Census Area, Alaska",6876,3779,3097
5ea728146307ba36aa1df58d,2261,05000US02261,Valdez-Cordova Census Area,"Valdez-Cordova Census Area, Alaska",9301,4898,4403
5ea728146307ba36aa1df58e,2275,05000US02275,Wrangell City and Borough,"Wrangell City and Borough, Alaska",2484,1302,1182
5ea728146307ba36aa1df58f,2282,05000US02282,Yakutat City and Borough,"Yakutat City and Borough, Alaska",689,369,320
5ea728146307ba36aa1df590,2290,05000US02290,Yukon-Koyukuk Census Area,"Yukon-Koyukuk Census Area, Alaska",5415,2910,2505
5ea728146307ba36aa1df591,4001,05000US04001,Apache County,"Apache County, Arizona",71522,35240,36282
5ea728146307ba36aa1df592,4003,05000US04003,Cochise County,"Cochise County, Arizona",126279,64135,62144
5ea728146307ba36aa1df593,4005,05000US04005,Coconino County,"Coconino County, Arizona",140217,68918,71299
5ea728146307ba36aa1df594,4007,05000US04007,Gila County,"Gila County, Arizona",53400,26370,27030
5ea728146307ba36aa1df595,4009,05000US04009,Graham County,"Graham County, Arizona",37879,20330,17549
5ea728146307ba36aa1df596,4011,05000US04011,Greenlee County,"Greenlee County, Arizona",9504,5064,4440
5ea728146307ba36aa1df597,4012,05000US04012,La Paz County,"La Paz County, Arizona",20701,10677,10024
5ea728146307ba36aa1df598,4013,05000US04013,Maricopa County,"Maricopa County, Arizona",4253913,2104145,2149768
5ea728146307ba36aa1df599,4015,05000US04015,Mohave County,"Mohave County, Arizona",206064,104047,102017
5ea728146307ba36aa1df59a,4017,05000US04017,Navajo County,"Navajo County, Arizona",108705,54533,54172
5ea728146307ba36aa1df59b,4019,05000US04019,Pima County,"Pima County, Arizona",1019722,501879,517843
5ea728146307ba36aa1df59c,4021,05000US04021,Pinal County,"Pinal County, Arizona",419721,219048,200673
5ea728146307ba36aa1df59d,4023,05000US04023,Santa Cruz County,"Santa Cruz County, Arizona",46584,22285,24299
5ea728146307ba36aa1df59e,4025,05000US04025,Yavapai County,"Yavapai County, Arizona",224645,109795,114850
5ea728146307ba36aa1df59f,4027,05000US04027,Yuma County,"Yuma County, Arizona",207829,106973,100856
5ea728146307ba36aa1df5a0,5001,05000US05001,Arkansas County,"Arkansas County, Arkansas",18124,8733,9391
5ea728146307ba36aa1df5a1,5003,05000US05003,Ashley County,"Ashley County, Arkansas",20537,10013,10524
5ea728146307ba36aa1df5a2,5005,05000US05005,Baxter County,"Baxter County, Arkansas",41219,19992,21227
5ea728146307ba36aa1df5a3,5007,05000US05007,Benton County,"Benton County, Arkansas",258980,128399,130581
5ea728146307ba36aa1df5a4,5009,05000US05009,Boone County,"Boone County, Arkansas",37288,18350,18938
5ea728146307ba36aa1df5a5,5011,05000US05011,Bradley County,"Bradley County, Arkansas",10948,5214,5734
5ea728146307ba36aa1df5a6,5013,05000US05013,Calhoun County,"Calhoun County, Arkansas",5202,2607,2595
5ea728146307ba36aa1df5a7,5015,05000US05015,Carroll County,"Carroll County, Arkansas",27887,13897,13990
5ea728146307ba36aa1df5a8,5017,05000US05017,Chicot County,"Chicot County, Arkansas",10826,5266,5560
5ea728146307ba36aa1df5a9,5019,05000US05019,Clark County,"Clark County, Arkansas",22385,10628,11757
5ea728146307ba36aa1df5aa,5021,05000US05021,Clay County,"Clay County, Arkansas",15061,7414,7647
5ea728146307ba36aa1df5ab,5023,05000US05023,Cleburne County,"Cleburne County, Arkansas",25230,12472,12758
5ea728146307ba36aa1df5ac,5025,05000US05025,Cleveland County,"Cleveland County, Arkansas",8226,4138,4088
5ea728146307ba36aa1df5ad,5027,05000US05027,Columbia County,"Columbia County, Arkansas",23892,11444,12448
5ea728146307ba36aa1df5ae,5029,05000US05029,Conway County,"Conway County, Arkansas",20906,10182,10724
5ea728146307ba36aa1df5af,5031,05000US05031,Craighead County,"Craighead County, Arkansas",105701,51528,54173
5ea728146307ba36aa1df5b0,5033,05000US05033,Crawford County,"Crawford County, Arkansas",62472,30761,31711
5ea728146307ba36aa1df5b1,5035,05000US05035,Crittenden County,"Crittenden County, Arkansas",49013,23271,25742
5ea728146307ba36aa1df5b2,5037,05000US05037,Cross County,"Cross County, Arkansas",16998,8200,8798
5ea728146307ba36aa1df5b3,5039,05000US05039,Dallas County,"Dallas County, Arkansas",7432,3618,3814
5ea728146307ba36aa1df5b4,5041,05000US05041,Desha County,"Desha County, Arkansas",11887,5623,6264
5ea728146307ba36aa1df5b5,5043,05000US05043,Drew County,"Drew County, Arkansas",18502,9033,9469
5ea728146307ba36aa1df5b6,5045,05000US05045,Faulkner County,"Faulkner County, Arkansas",122416,59911,62505
5ea728146307ba36aa1df5b7,5047,05000US05047,Franklin County,"Franklin County, Arkansas",17780,8675,9105
5ea728146307ba36aa1df5b8,5049,05000US05049,Fulton County,"Fulton County, Arkansas",12139,6048,6091
5ea728146307ba36aa1df5b9,5051,05000US05051,Garland County,"Garland County, Arkansas",98296,47182,51114
5ea728146307ba36aa1df5ba,5053,05000US05053,Grant County,"Grant County, Arkansas",18086,8870,9216
5ea728146307ba36aa1df5bb,5055,05000US05055,Greene County,"Greene County, Arkansas",44623,21912,22711
5ea728146307ba36aa1df5bc,5057,05000US05057,Hempstead County,"Hempstead County, Arkansas",22018,10494,11524
5ea728146307ba36aa1df5bd,5059,05000US05059,Hot Spring County,"Hot Spring County, Arkansas",33520,17418,16102
5ea728146307ba36aa1df5be,5061,05000US05061,Howard County,"Howard County, Arkansas",13389,6440,6949
5ea728146307ba36aa1df5bf,5063,05000US05063,Independence County,"Independence County, Arkansas",37264,18092,19172
5ea728146307ba36aa1df5c0,5065,05000US05065,Izard County,"Izard County, Arkansas",13559,7018,6541
5ea728146307ba36aa1df5c1,5067,05000US05067,Jackson County,"Jackson County, Arkansas",17225,8512,8713
5ea728146307ba36aa1df5c2,5069,05000US05069,Jefferson County,"Jefferson County, Arkansas",70424,34906,35518
5ea728146307ba36aa1df5c3,5071,05000US05071,Johnson County,"Johnson County, Arkansas",26291,12976,13315
5ea728146307ba36aa1df5c4,5073,05000US05073,Lafayette County,"Lafayette County, Arkansas",6915,3381,3534
5ea728146307ba36aa1df5c5,5075,05000US05075,Lawrence County,"Lawrence County, Arkansas",16669,8270,8399
5ea728146307ba36aa1df5c6,5077,05000US05077,Lee County,"Lee County, Arkansas",9398,5309,4089
5ea728146307ba36aa1df5c7,5079,05000US05079,Lincoln County,"Lincoln County, Arkansas",13695,8590,5105
5ea728146307ba36aa1df5c8,5081,05000US05081,Little River County,"Little River County, Arkansas",12417,6090,6327
5ea728146307ba36aa1df5c9,5083,05000US05083,Logan County,"Logan County, Arkansas",21757,10643,11114
5ea728146307ba36aa1df5ca,5085,05000US05085,Lonoke County,"Lonoke County, Arkansas",72206,35667,36539
5ea728146307ba36aa1df5cb,5087,05000US05087,Madison County,"Madison County, Arkansas",16076,8038,8038
5ea728146307ba36aa1df5cc,5089,05000US05089,Marion County,"Marion County, Arkansas",16438,7990,8448
5ea728146307ba36aa1df5cd,5091,05000US05091,Miller County,"Miller County, Arkansas",43759,21476,22283
5ea728146307ba36aa1df5ce,5093,05000US05093,Mississippi County,"Mississippi County, Arkansas",42831,20876,21955
5ea728146307ba36aa1df5cf,5095,05000US05095,Monroe County,"Monroe County, Arkansas",7249,3316,3933
5ea728146307ba36aa1df5d0,5097,05000US05097,Montgomery County,"Montgomery County, Arkansas",8993,4440,4553
5ea728146307ba36aa1df5d1,5099,05000US05099,Nevada County,"Nevada County, Arkansas",8440,4425,4015
5ea728146307ba36aa1df5d2,5101,05000US05101,Newton County,"Newton County, Arkansas",7848,3932,3916
5ea728146307ba36aa1df5d3,5103,05000US05103,Ouachita County,"Ouachita County, Arkansas",24106,11327,12779
5ea728146307ba36aa1df5d4,5105,05000US05105,Perry County,"Perry County, Arkansas",10322,5184,5138
5ea728146307ba36aa1df5d5,5107,05000US05107,Phillips County,"Phillips County, Arkansas",19034,9006,10028
5ea728146307ba36aa1df5d6,5109,05000US05109,Pike County,"Pike County, Arkansas",10808,5346,5462
5ea728146307ba36aa1df5d7,5111,05000US05111,Poinsett County,"Poinsett County, Arkansas",24054,11734,12320
5ea728146307ba36aa1df5d8,5113,05000US05113,Polk County,"Polk County, Arkansas",20163,9828,10335
5ea728146307ba36aa1df5d9,5115,05000US05115,Pope County,"Pope County, Arkansas",63644,31317,32327
5ea728146307ba36aa1df5da,5117,05000US05117,Prairie County,"Prairie County, Arkansas",8244,4120,4124
5ea728146307ba36aa1df5db,5119,05000US05119,Pulaski County,"Pulaski County, Arkansas",393463,188496,204967
5ea728146307ba36aa1df5dc,5121,05000US05121,Randolph County,"Randolph County, Arkansas",17603,8784,8819
5ea728146307ba36aa1df5dd,5123,05000US05123,St. Francis County,"St. Francis County, Arkansas",26294,14441,11853
5ea728146307ba36aa1df5de,5125,05000US05125,Saline County,"Saline County, Arkansas",118009,58030,59979
5ea728146307ba36aa1df5df,5127,05000US05127,Scott County,"Scott County, Arkansas",10442,5332,5110
5ea728146307ba36aa1df5e0,5129,05000US05129,Searcy County,"Searcy County, Arkansas",7923,3981,3942
5ea728146307ba36aa1df5e1,5131,05000US05131,Sebastian County,"Sebastian County, Arkansas",127461,62274,65187
5ea728146307ba36aa1df5e2,5133,05000US05133,Sevier County,"Sevier County, Arkansas",17193,8607,8586
5ea728146307ba36aa1df5e3,5135,05000US05135,Sharp County,"Sharp County, Arkansas",17043,8335,8708
5ea728146307ba36aa1df5e4,5137,05000US05137,Stone County,"Stone County, Arkansas",12446,6209,6237
5ea728146307ba36aa1df5e5,5139,05000US05139,Union County,"Union County, Arkansas",39732,19332,20400
5ea728146307ba36aa1df5e6,5141,05000US05141,Van Buren County,"Van Buren County, Arkansas",16684,8284,8400
5ea728146307ba36aa1df5e7,5143,05000US05143,Washington County,"Washington County, Arkansas",228529,114181,114348
5ea728146307ba36aa1df5e8,5145,05000US05145,White County,"White County, Arkansas",78804,38751,40053
5ea728146307ba36aa1df5e9,5147,05000US05147,Woodruff County,"Woodruff County, Arkansas",6660,3051,3609
5ea728146307ba36aa1df5ea,5149,05000US05149,Yell County,"Yell County, Arkansas",21573,10782,10791
5ea728146307ba36aa1df5eb,6001,05000US06001,Alameda County,"Alameda County, California",1643700,807171,836529
5ea728146307ba36aa1df5ec,6003,05000US06003,Alpine County,"Alpine County, California",1146,612,534
5ea728146307ba36aa1df5ed,6005,05000US06005,Amador County,"Amador County, California",37829,20302,17527
5ea728146307ba36aa1df5ee,6007,05000US06007,Butte County,"Butte County, California",227075,112513,114562
5ea728146307ba36aa1df5ef,6009,05000US06009,Calaveras County,"Calaveras County, California",45235,22434,22801
5ea728146307ba36aa1df5f0,6011,05000US06011,Colusa County,"Colusa County, California",21464,11124,10340
5ea728146307ba36aa1df5f1,6013,05000US06013,Contra Costa County,"Contra Costa County, California",1133247,553701,579546
5ea728146307ba36aa1df5f2,6015,05000US06015,Del Norte County,"Del Norte County, California",27424,14575,12849
5ea728146307ba36aa1df5f3,6017,05000US06017,El Dorado County,"El Dorado County, California",186661,93040,93621
5ea728146307ba36aa1df5f4,6019,05000US06019,Fresno County,"Fresno County, California",978130,487936,490194
5ea728146307ba36aa1df5f5,6021,05000US06021,Glenn County,"Glenn County, California",27897,14171,13726
5ea728146307ba36aa1df5f6,6023,05000US06023,Humboldt County,"Humboldt County, California",135768,67666,68102
5ea728146307ba36aa1df5f7,6025,05000US06025,Imperial County,"Imperial County, California",180216,92250,87966
5ea728146307ba36aa1df5f8,6027,05000US06027,Inyo County,"Inyo County, California",18085,9084,9001
5ea728146307ba36aa1df5f9,6029,05000US06029,Kern County,"Kern County, California",883053,452646,430407
5ea728146307ba36aa1df5fa,6031,05000US06031,Kings County,"Kings County, California",150075,82674,67401
5ea728146307ba36aa1df5fb,6033,05000US06033,Lake County,"Lake County, California",64148,31879,32269
5ea728146307ba36aa1df5fc,6035,05000US06035,Lassen County,"Lassen County, California",31185,20671,10514
5ea728146307ba36aa1df5fd,6037,05000US06037,Los Angeles County,"Los Angeles County, California",10098052,4976788,5121264
5ea728146307ba36aa1df5fe,6039,05000US06039,Madera County,"Madera County, California",155013,74683,80330
5ea728146307ba36aa1df5ff,6041,05000US06041,Marin County,"Marin County, California",260295,127113,133182
5ea728146307ba36aa1df600,6043,05000US06043,Mariposa County,"Mariposa County, California",17540,8920,8620
5ea728146307ba36aa1df601,6045,05000US06045,Mendocino County,"Mendocino County, California",87422,43439,43983
5ea728146307ba36aa1df602,6047,05000US06047,Merced County,"Merced County, California",269075,135816,133259
5ea728146307ba36aa1df603,6049,05000US06049,Modoc County,"Modoc County, California",8938,4613,4325
5ea728146307ba36aa1df604,6051,05000US06051,Mono County,"Mono County, California",14174,7341,6833
5ea728146307ba36aa1df605,6053,05000US06053,Monterey County,"Monterey County, California",433212,220967,212245
5ea728146307ba36aa1df606,6055,05000US06055,Napa County,"Napa County, California",140530,70082,70448
5ea728146307ba36aa1df607,6057,05000US06057,Nevada County,"Nevada County, California",99092,48889,50203
5ea728146307ba36aa1df608,6059,05000US06059,Orange County,"Orange County, California",3164182,1562429,1601753
5ea728146307ba36aa1df609,6061,05000US06061,Placer County,"Placer County, California",380077,185511,194566
5ea728146307ba36aa1df60a,6063,05000US06063,Plumas County,"Plumas County, California",18699,9423,9276
5ea728146307ba36aa1df60b,6065,05000US06065,Riverside County,"Riverside County, California",2383286,1186188,1197098
5ea728146307ba36aa1df60c,6067,05000US06067,Sacramento County,"Sacramento County, California",1510023,737742,772281
5ea728146307ba36aa1df60d,6069,05000US06069,San Benito County,"San Benito County, California",59416,29626,29790
5ea728146307ba36aa1df60e,6071,05000US06071,San Bernardino County,"San Bernardino County, California",2135413,1062472,1072941
5ea728146307ba36aa1df60f,6073,05000US06073,San Diego County,"San Diego County, California",3302833,1661931,1640902
5ea728146307ba36aa1df610,6075,05000US06075,San Francisco County,"San Francisco County, California",870044,443970,426074
5ea728146307ba36aa1df611,6077,05000US06077,San Joaquin County,"San Joaquin County, California",732212,364612,367600
5ea728146307ba36aa1df612,6079,05000US06079,San Luis Obispo County,"San Luis Obispo County, California",281455,142769,138686
5ea728146307ba36aa1df613,6081,05000US06081,San Mateo County,"San Mateo County, California",765935,377851,388084
5ea728146307ba36aa1df614,6083,05000US06083,Santa Barbara County,"Santa Barbara County, California",443738,222208,221530
5ea728146307ba36aa1df615,6085,05000US06085,Santa Clara County,"Santa Clara County, California",1922200,970469,951731
5ea728146307ba36aa1df616,6087,05000US06087,Santa Cruz County,"Santa Cruz County, California",273765,135727,138038
5ea728146307ba36aa1df617,6089,05000US06089,Shasta County,"Shasta County, California",179085,87859,91226
5ea728146307ba36aa1df618,6091,05000US06091,Sierra County,"Sierra County, California",2930,1542,1388
5ea728146307ba36aa1df619,6093,05000US06093,Siskiyou County,"Siskiyou County, California",43540,21706,21834
5ea728146307ba36aa1df61a,6095,05000US06095,Solano County,"Solano County, California",438530,217931,220599
5ea728146307ba36aa1df61b,6097,05000US06097,Sonoma County,"Sonoma County, California",501317,245196,256121
5ea728146307ba36aa1df61c,6099,05000US06099,Stanislaus County,"Stanislaus County, California",539301,266844,272457
5ea728146307ba36aa1df61d,6101,05000US06101,Sutter County,"Sutter County, California",95872,47789,48083
5ea728146307ba36aa1df61e,6103,05000US06103,Tehama County,"Tehama County, California",63373,31504,31869
5ea728146307ba36aa1df61f,6105,05000US06105,Trinity County,"Trinity County, California",12862,6582,6280
5ea728146307ba36aa1df620,6107,05000US06107,Tulare County,"Tulare County, California",460477,230255,230222
5ea728146307ba36aa1df621,6109,05000US06109,Tuolumne County,"Tuolumne County, California",53932,28102,25830
5ea728146307ba36aa1df622,6111,05000US06111,Ventura County,"Ventura County, California",848112,419588,428524
5ea728146307ba36aa1df623,6113,05000US06113,Yolo County,"Yolo County, California",214977,104375,110602
5ea728146307ba36aa1df624,6115,05000US06115,Yuba County,"Yuba County, California",75493,38468,37025
5ea728146307ba36aa1df625,8001,05000US08001,Adams County,"Adams County, Colorado",497115,250704,246411
5ea728146307ba36aa1df626,8003,05000US08003,Alamosa County,"Alamosa County, Colorado",16444,8242,8202
5ea728146307ba36aa1df627,8005,05000US08005,Arapahoe County,"Arapahoe County, Colorado",636671,314672,321999
5ea728146307ba36aa1df628,8007,05000US08007,Archuleta County,"Archuleta County, Colorado",12908,6546,6362
5ea728146307ba36aa1df629,8009,05000US08009,Baca County,"Baca County, Colorado",3563,1755,1808
5ea728146307ba36aa1df62a,8011,05000US08011,Bent County,"Bent County, Colorado",5809,3790,2019
5ea728146307ba36aa1df62b,8013,05000US08013,Boulder County,"Boulder County, Colorado",321030,161355,159675
5ea728146307ba36aa1df62c,8014,05000US08014,Broomfield County,"Broomfield County, Colorado",66120,32789,33331
5ea728146307ba36aa1df62d,8015,05000US08015,Chaffee County,"Chaffee County, Colorado",19164,10268,8896
5ea728146307ba36aa1df62e,8017,05000US08017,Cheyenne County,"Cheyenne County, Colorado",2039,964,1075
5ea728146307ba36aa1df62f,8019,05000US08019,Clear Creek County,"Clear Creek County, Colorado",9379,4816,4563
5ea728146307ba36aa1df630,8021,05000US08021,Conejos County,"Conejos County, Colorado",8142,4082,4060
5ea728146307ba36aa1df631,8023,05000US08023,Costilla County,"Costilla County, Colorado",3687,1941,1746
5ea728146307ba36aa1df632,8025,05000US08025,Crowley County,"Crowley County, Colorado",5630,3526,2104
5ea728146307ba36aa1df633,8027,05000US08027,Custer County,"Custer County, Colorado",4640,2265,2375
5ea728146307ba36aa1df634,8029,05000US08029,Delta County,"Delta County, Colorado",30346,15235,15111
5ea728146307ba36aa1df635,8031,05000US08031,Denver County,"Denver County, Colorado",693417,347188,346229
5ea728146307ba36aa1df636,8033,05000US08033,Dolores County,"Dolores County, Colorado",1841,989,852
5ea728146307ba36aa1df637,8035,05000US08035,Douglas County,"Douglas County, Colorado",328614,163766,164848
5ea728146307ba36aa1df638,8037,05000US08037,Eagle County,"Eagle County, Colorado",54357,28804,25553
5ea728146307ba36aa1df639,8039,05000US08039,Elbert County,"Elbert County, Colorado",25162,12721,12441
5ea728146307ba36aa1df63a,8041,05000US08041,El Paso County,"El Paso County, Colorado",688153,347478,340675
5ea728146307ba36aa1df63b,8043,05000US08043,Fremont County,"Fremont County, Colorado",47002,27324,19678
5ea728146307ba36aa1df63c,8045,05000US08045,Garfield County,"Garfield County, Colorado",58538,29779,28759
5ea728146307ba36aa1df63d,8047,05000US08047,Gilpin County,"Gilpin County, Colorado",5924,3169,2755
5ea728146307ba36aa1df63e,8049,05000US08049,Grand County,"Grand County, Colorado",15066,8129,6937
5ea728146307ba36aa1df63f,8051,05000US08051,Gunnison County,"Gunnison County, Colorado",16537,8983,7554
5ea728146307ba36aa1df640,8053,05000US08053,Hinsdale County,"Hinsdale County, Colorado",878,406,472
5ea728146307ba36aa1df641,8055,05000US08055,Huerfano County,"Huerfano County, Colorado",6583,3305,3278
5ea728146307ba36aa1df642,8057,05000US08057,Jackson County,"Jackson County, Colorado",1296,631,665
5ea728146307ba36aa1df643,8059,05000US08059,Jefferson County,"Jefferson County, Colorado",570427,283919,286508
5ea728146307ba36aa1df644,8061,05000US08061,Kiowa County,"Kiowa County, Colorado",1449,750,699
5ea728146307ba36aa1df645,8063,05000US08063,Kit Carson County,"Kit Carson County, Colorado",7635,4158,3477
5ea728146307ba36aa1df646,8065,05000US08065,Lake County,"Lake County, Colorado",7585,4176,3409
5ea728146307ba36aa1df647,8067,05000US08067,La Plata County,"La Plata County, Colorado",55101,27790,27311
5ea728146307ba36aa1df648,8069,05000US08069,Larimer County,"Larimer County, Colorado",338161,168615,169546
5ea728146307ba36aa1df649,8071,05000US08071,Las Animas County,"Las Animas County, Colorado",14179,7452,6727
5ea728146307ba36aa1df64a,8073,05000US08073,Lincoln County,"Lincoln County, Colorado",5548,3471,2077
5ea728146307ba36aa1df64b,8075,05000US08075,Logan County,"Logan County, Colorado",21689,11708,9981
5ea728146307ba36aa1df64c,8077,05000US08077,Mesa County,"Mesa County, Colorado",149998,74027,75971
5ea728146307ba36aa1df64d,8079,05000US08079,Mineral County,"Mineral County, Colorado",823,402,421
5ea728146307ba36aa1df64e,8081,05000US08081,Moffat County,"Moffat County, Colorado",13060,6698,6362
5ea728146307ba36aa1df64f,8083,05000US08083,Montezuma County,"Montezuma County, Colorado",25909,12760,13149
5ea728146307ba36aa1df650,8085,05000US08085,Montrose County,"Montrose County, Colorado",41268,20374,20894
5ea728146307ba36aa1df651,8087,05000US08087,Morgan County,"Morgan County, Colorado",28257,14112,14145
5ea728146307ba36aa1df652,8089,05000US08089,Otero County,"Otero County, Colorado",18325,8872,9453
5ea728146307ba36aa1df653,8091,05000US08091,Ouray County,"Ouray County, Colorado",4722,2312,2410
5ea728146307ba36aa1df654,8093,05000US08093,Park County,"Park County, Colorado",17392,9172,8220
5ea728146307ba36aa1df655,8095,05000US08095,Phillips County,"Phillips County, Colorado",4318,2295,2023
5ea728146307ba36aa1df656,8097,05000US08097,Pitkin County,"Pitkin County, Colorado",17909,9408,8501
5ea728146307ba36aa1df657,8099,05000US08099,Prowers County,"Prowers County, Colorado",12052,6035,6017
5ea728146307ba36aa1df658,8101,05000US08101,Pueblo County,"Pueblo County, Colorado",164685,80962,83723
5ea728146307ba36aa1df659,8103,05000US08103,Rio Blanco County,"Rio Blanco County, Colorado",6465,3291,3174
5ea728146307ba36aa1df65a,8105,05000US08105,Rio Grande County,"Rio Grande County, Colorado",11351,5696,5655
5ea728146307ba36aa1df65b,8107,05000US08107,Routt County,"Routt County, Colorado",24874,12915,11959
5ea728146307ba36aa1df65c,8109,05000US08109,Saguache County,"Saguache County, Colorado",6468,3182,3286
5ea728146307ba36aa1df65d,8111,05000US08111,San Juan County,"San Juan County, Colorado",544,283,261
5ea728146307ba36aa1df65e,8113,05000US08113,San Miguel County,"San Miguel County, Colorado",7968,4215,3753
5ea728146307ba36aa1df65f,8115,05000US08115,Sedgwick County,"Sedgwick County, Colorado",2350,1162,1188
5ea728146307ba36aa1df660,8117,05000US08117,Summit County,"Summit County, Colorado",30429,16684,13745
5ea728146307ba36aa1df661,8119,05000US08119,Teller County,"Teller County, Colorado",24113,12157,11956
5ea728146307ba36aa1df662,8121,05000US08121,Washington County,"Washington County, Colorado",4840,2510,2330
5ea728146307ba36aa1df663,8123,05000US08123,Weld County,"Weld County, Colorado",295123,148627,146496
5ea728146307ba36aa1df664,8125,05000US08125,Yuma County,"Yuma County, Colorado",10069,5019,5050
5ea728146307ba36aa1df665,9001,05000US09001,Fairfield County,"Fairfield County, Connecticut",944348,459963,484385
5ea728146307ba36aa1df666,9003,05000US09003,Hartford County,"Hartford County, Connecticut",894730,434650,460080
5ea728146307ba36aa1df667,9005,05000US09005,Litchfield County,"Litchfield County, Connecticut",183031,90447,92584
5ea728146307ba36aa1df668,9007,05000US09007,Middlesex County,"Middlesex County, Connecticut",163368,79676,83692
5ea728146307ba36aa1df669,9009,05000US09009,New Haven County,"New Haven County, Connecticut",859339,414311,445028
5ea728146307ba36aa1df66a,9011,05000US09011,New London County,"New London County, Connecticut",268881,134703,134178
5ea728146307ba36aa1df66b,9013,05000US09013,Tolland County,"Tolland County, Connecticut",151269,75821,75448
5ea728146307ba36aa1df66c,9015,05000US09015,Windham County,"Windham County, Connecticut",116538,57560,58978
5ea728146307ba36aa1df66d,10001,05000US10001,Kent County,"Kent County, Delaware",174822,84271,90551
5ea728146307ba36aa1df66e,10003,05000US10003,New Castle County,"New Castle County, Delaware",555133,268870,286263
5ea728146307ba36aa1df66f,10005,05000US10005,Sussex County,"Sussex County, Delaware",219540,106429,113111
5ea728146307ba36aa1df670,11001,05000US11001,District of Columbia,"District of Columbia, District of Columbia",684498,324881,359617
5ea728146307ba36aa1df671,12001,05000US12001,Alachua County,"Alachua County, Florida",263148,127298,135850
5ea728146307ba36aa1df672,12003,05000US12003,Baker County,"Baker County, Florida",27785,14753,13032
5ea728146307ba36aa1df673,12005,05000US12005,Bay County,"Bay County, Florida",182482,90768,91714
5ea728146307ba36aa1df674,12007,05000US12007,Bradford County,"Bradford County, Florida",26979,14841,12138
5ea728146307ba36aa1df675,12009,05000US12009,Brevard County,"Brevard County, Florida",576808,282023,294785
5ea728146307ba36aa1df676,12011,05000US12011,Broward County,"Broward County, Florida",1909151,929712,979439
5ea728146307ba36aa1df677,12013,05000US12013,Calhoun County,"Calhoun County, Florida",14444,8048,6396
5ea728146307ba36aa1df678,12015,05000US12015,Charlotte County,"Charlotte County, Florida",176954,86278,90676
5ea728146307ba36aa1df679,12017,05000US12017,Citrus County,"Citrus County, Florida",143087,69376,73711
5ea728146307ba36aa1df67a,12019,05000US12019,Clay County,"Clay County, Florida",207291,102225,105066
5ea728146307ba36aa1df67b,12021,05000US12021,Collier County,"Collier County, Florida",363922,179336,184586
5ea728146307ba36aa1df67c,12023,05000US12023,Columbia County,"Columbia County, Florida",69105,35683,33422
5ea728146307ba36aa1df67d,12027,05000US12027,DeSoto County,"DeSoto County, Florida",36399,20657,15742
5ea728146307ba36aa1df67e,12029,05000US12029,Dixie County,"Dixie County, Florida",16437,9218,7219
5ea728146307ba36aa1df67f,12031,05000US12031,Duval County,"Duval County, Florida",924229,448163,476066
5ea728146307ba36aa1df680,12033,05000US12033,Escambia County,"Escambia County, Florida",311522,154520,157002
5ea728146307ba36aa1df681,12035,05000US12035,Flagler County,"Flagler County, Florida",107139,51187,55952
5ea728146307ba36aa1df682,12037,05000US12037,Franklin County,"Franklin County, Florida",11736,6714,5022
5ea728146307ba36aa1df683,12039,05000US12039,Gadsden County,"Gadsden County, Florida",46017,21785,24232
5ea728146307ba36aa1df684,12041,05000US12041,Gilchrist County,"Gilchrist County, Florida",17615,9249,8366
5ea728146307ba36aa1df685,12043,05000US12043,Glades County,"Glades County, Florida",13363,7303,6060
5ea728146307ba36aa1df686,12045,05000US12045,Gulf County,"Gulf County, Florida",16055,9586,6469
5ea728146307ba36aa1df687,12047,05000US12047,Hamilton County,"Hamilton County, Florida",14269,8281,5988
5ea728146307ba36aa1df688,12049,05000US12049,Hardee County,"Hardee County, Florida",27228,14705,12523
5ea728146307ba36aa1df689,12051,05000US12051,Hendry County,"Hendry County, Florida",40127,21437,18690
5ea728146307ba36aa1df68a,12053,05000US12053,Hernando County,"Hernando County, Florida",182696,87747,94949
5ea728146307ba36aa1df68b,12055,05000US12055,Highlands County,"Highlands County, Florida",102101,49727,52374
5ea728146307ba36aa1df68c,12057,05000US12057,Hillsborough County,"Hillsborough County, Florida",1378883,673286,705597
5ea728146307ba36aa1df68d,12059,05000US12059,Holmes County,"Holmes County, Florida",19430,10484,8946
5ea728146307ba36aa1df68e,12061,05000US12061,Indian River County,"Indian River County, Florida",150984,72290,78694
5ea728146307ba36aa1df68f,12063,05000US12063,Jackson County,"Jackson County, Florida",48472,26784,21688
5ea728146307ba36aa1df690,12065,05000US12065,Jefferson County,"Jefferson County, Florida",14105,7507,6598
5ea728146307ba36aa1df691,12067,05000US12067,Lafayette County,"Lafayette County, Florida",8744,5066,3678
5ea728146307ba36aa1df692,12069,05000US12069,Lake County,"Lake County, Florida",335362,162402,172960
5ea728146307ba36aa1df693,12071,05000US12071,Lee County,"Lee County, Florida",718679,351918,366761
5ea728146307ba36aa1df694,12073,05000US12073,Leon County,"Leon County, Florida",288102,136894,151208
5ea728146307ba36aa1df695,12075,05000US12075,Levy County,"Levy County, Florida",39961,19364,20597
5ea728146307ba36aa1df696,12077,05000US12077,Liberty County,"Liberty County, Florida",8365,5110,3255
5ea728146307ba36aa1df697,12079,05000US12079,Madison County,"Madison County, Florida",18474,9829,8645
5ea728146307ba36aa1df698,12081,05000US12081,Manatee County,"Manatee County, Florida",373853,180595,193258
5ea728146307ba36aa1df699,12083,05000US12083,Marion County,"Marion County, Florida",348371,167211,181160
5ea728146307ba36aa1df69a,12085,05000US12085,Martin County,"Martin County, Florida",157581,78002,79579
5ea728146307ba36aa1df69b,12086,05000US12086,Miami-Dade County,"Miami-Dade County, Florida",2715516,1318627,1396889
5ea728146307ba36aa1df69c,12087,05000US12087,Monroe County,"Monroe County, Florida",76325,39822,36503
5ea728146307ba36aa1df69d,12089,05000US12089,Nassau County,"Nassau County, Florida",80578,39956,40622
5ea728146307ba36aa1df69e,12091,05000US12091,Okaloosa County,"Okaloosa County, Florida",200737,101745,98992
5ea728146307ba36aa1df69f,12093,05000US12093,Okeechobee County,"Okeechobee County, Florida",40572,21866,18706
5ea728146307ba36aa1df6a0,12095,05000US12095,Orange County,"Orange County, Florida",1321194,648446,672748
5ea728146307ba36aa1df6a1,12097,05000US12097,Osceola County,"Osceola County, Florida",338619,166820,171799
5ea728146307ba36aa1df6a2,12099,05000US12099,Palm Beach County,"Palm Beach County, Florida",1446277,701207,745070
5ea728146307ba36aa1df6a3,12101,05000US12101,Pasco County,"Pasco County, Florida",510593,248572,262021
5ea728146307ba36aa1df6a4,12103,05000US12103,Pinellas County,"Pinellas County, Florida",957875,459766,498109
5ea728146307ba36aa1df6a5,12105,05000US12105,Polk County,"Polk County, Florida",668671,327706,340965
5ea728146307ba36aa1df6a6,12107,05000US12107,Putnam County,"Putnam County, Florida",72766,35841,36925
5ea728146307ba36aa1df6a7,12109,05000US12109,St. Johns County,"St. Johns County, Florida",235503,114660,120843
5ea728146307ba36aa1df6a8,12111,05000US12111,St. Lucie County,"St. Lucie County, Florida",305591,149385,156206
5ea728146307ba36aa1df6a9,12113,05000US12113,Santa Rosa County,"Santa Rosa County, Florida",170442,87175,83267
5ea728146307ba36aa1df6aa,12115,05000US12115,Sarasota County,"Sarasota County, Florida",412144,196433,215711
5ea728146307ba36aa1df6ab,12117,05000US12117,Seminole County,"Seminole County, Florida",455086,219935,235151
5ea728146307ba36aa1df6ac,12119,05000US12119,Sumter County,"Sumter County, Florida",120999,60725,60274
5ea728146307ba36aa1df6ad,12121,05000US12121,Suwannee County,"Suwannee County, Florida",43924,22230,21694
5ea728146307ba36aa1df6ae,12123,05000US12123,Taylor County,"Taylor County, Florida",22098,12414,9684
5ea728146307ba36aa1df6af,12125,05000US12125,Union County,"Union County, Florida",15239,9919,5320
5ea728146307ba36aa1df6b0,12127,05000US12127,Volusia County,"Volusia County, Florida",527634,257275,270359
5ea728146307ba36aa1df6b1,12129,05000US12129,Wakulla County,"Wakulla County, Florida",31877,17490,14387
5ea728146307ba36aa1df6b2,12131,05000US12131,Walton County,"Walton County, Florida",65858,33317,32541
5ea728146307ba36aa1df6b3,12133,05000US12133,Washington County,"Washington County, Florida",24566,13231,11335
5ea728146307ba36aa1df6b4,13001,05000US13001,Appling County,"Appling County, Georgia",18454,9353,9101
5ea728146307ba36aa1df6b5,13003,05000US13003,Atkinson County,"Atkinson County, Georgia",8265,4208,4057
5ea728146307ba36aa1df6b6,13005,05000US13005,Bacon County,"Bacon County, Georgia",11228,5564,5664
5ea728146307ba36aa1df6b7,13007,05000US13007,Baker County,"Baker County, Georgia",3189,1521,1668
5ea728146307ba36aa1df6b8,13009,05000US13009,Baldwin County,"Baldwin County, Georgia",45286,22759,22527
5ea728146307ba36aa1df6b9,13011,05000US13011,Banks County,"Banks County, Georgia",18510,9281,9229
5ea728146307ba36aa1df6ba,13013,05000US13013,Barrow County,"Barrow County, Georgia",76887,37771,39116
5ea728146307ba36aa1df6bb,13015,05000US13015,Bartow County,"Bartow County, Georgia",103620,51332,52288
5ea728146307ba36aa1df6bc,13017,05000US13017,Ben Hill County,"Ben Hill County, Georgia",17154,8047,9107
5ea728146307ba36aa1df6bd,13019,05000US13019,Berrien County,"Berrien County, Georgia",19025,9299,9726
5ea728146307ba36aa1df6be,13021,05000US13021,Bibb County,"Bibb County, Georgia",153490,72065,81425
5ea728146307ba36aa1df6bf,13023,05000US13023,Bleckley County,"Bleckley County, Georgia",12775,5937,6838
5ea728146307ba36aa1df6c0,13025,05000US13025,Brantley County,"Brantley County, Georgia",18561,9103,9458
5ea728146307ba36aa1df6c1,13027,05000US13027,Brooks County,"Brooks County, Georgia",15622,7608,8014
5ea728146307ba36aa1df6c2,13029,05000US13029,Bryan County,"Bryan County, Georgia",35885,17786,18099
5ea728146307ba36aa1df6c3,13031,05000US13031,Bulloch County,"Bulloch County, Georgia",74782,36777,38005
5ea728146307ba36aa1df6c4,13033,05000US13033,Burke County,"Burke County, Georgia",22550,10697,11853
5ea728146307ba36aa1df6c5,13035,05000US13035,Butts County,"Butts County, Georgia",23750,12661,11089
5ea728146307ba36aa1df6c6,13037,05000US13037,Calhoun County,"Calhoun County, Georgia",6428,3875,2553
5ea728146307ba36aa1df6c7,13039,05000US13039,Camden County,"Camden County, Georgia",52714,27019,25695
5ea728146307ba36aa1df6c8,13043,05000US13043,Candler County,"Candler County, Georgia",10827,5363,5464
5ea728146307ba36aa1df6c9,13045,05000US13045,Carroll County,"Carroll County, Georgia",116022,56448,59574
5ea728146307ba36aa1df6ca,13047,05000US13047,Catoosa County,"Catoosa County, Georgia",66299,31991,34308
5ea728146307ba36aa1df6cb,13049,05000US13049,Charlton County,"Charlton County, Georgia",12983,7522,5461
5ea728146307ba36aa1df6cc,13051,05000US13051,Chatham County,"Chatham County, Georgia",287049,138403,148646
5ea728146307ba36aa1df6cd,13053,05000US13053,Chattahoochee County,"Chattahoochee County, Georgia",10767,7172,3595
5ea728146307ba36aa1df6ce,13055,05000US13055,Chattooga County,"Chattooga County, Georgia",24817,12865,11952
5ea728146307ba36aa1df6cf,13057,05000US13057,Cherokee County,"Cherokee County, Georgia",241910,119270,122640
5ea728146307ba36aa1df6d0,13059,05000US13059,Clarke County,"Clarke County, Georgia",124602,59248,65354
5ea728146307ba36aa1df6d1,13061,05000US13061,Clay County,"Clay County, Georgia",3001,1473,1528
5ea728146307ba36aa1df6d2,13063,05000US13063,Clayton County,"Clayton County, Georgia",278666,130748,147918
5ea728146307ba36aa1df6d3,13065,05000US13065,Clinch County,"Clinch County, Georgia",6743,3427,3316
5ea728146307ba36aa1df6d4,13067,05000US13067,Cobb County,"Cobb County, Georgia",745057,360270,384787
5ea728146307ba36aa1df6d5,13069,05000US13069,Coffee County,"Coffee County, Georgia",42961,22088,20873
5ea728146307ba36aa1df6d6,13071,05000US13071,Colquitt County,"Colquitt County, Georgia",45606,22554,23052
5ea728146307ba36aa1df6d7,13073,05000US13073,Columbia County,"Columbia County, Georgia",147295,71970,75325
5ea728146307ba36aa1df6d8,13075,05000US13075,Cook County,"Cook County, Georgia",17184,8348,8836
5ea728146307ba36aa1df6d9,13077,05000US13077,Coweta County,"Coweta County, Georgia",140516,68430,72086
5ea728146307ba36aa1df6da,13079,05000US13079,Crawford County,"Crawford County, Georgia",12344,6299,6045
5ea728146307ba36aa1df6db,13081,05000US13081,Crisp County,"Crisp County, Georgia",22846,10849,11997
5ea728146307ba36aa1df6dc,13083,05000US13083,Dade County,"Dade County, Georgia",16227,7932,8295
5ea728146307ba36aa1df6dd,13085,05000US13085,Dawson County,"Dawson County, Georgia",23861,11774,12087
5ea728146307ba36aa1df6de,13087,05000US13087,Decatur County,"Decatur County, Georgia",26833,12907,13926
5ea728146307ba36aa1df6df,13089,05000US13089,DeKalb County,"DeKalb County, Georgia",743187,351871,391316
5ea728146307ba36aa1df6e0,13091,05000US13091,Dodge County,"Dodge County, Georgia",20919,10972,9947
5ea728146307ba36aa1df6e1,13093,05000US13093,Dooly County,"Dooly County, Georgia",13905,7529,6376
5ea728146307ba36aa1df6e2,13095,05000US13095,Dougherty County,"Dougherty County, Georgia",91049,42144,48905
5ea728146307ba36aa1df6e3,13097,05000US13097,Douglas County,"Douglas County, Georgia",141840,67726,74114
5ea728146307ba36aa1df6e4,13099,05000US13099,Early County,"Early County, Georgia",10348,4791,5557
5ea728146307ba36aa1df6e5,13101,05000US13101,Echols County,"Echols County, Georgia",3994,1973,2021
5ea728146307ba36aa1df6e6,13103,05000US13103,Effingham County,"Effingham County, Georgia",58689,29215,29474
5ea728146307ba36aa1df6e7,13105,05000US13105,Elbert County,"Elbert County, Georgia",19212,9188,10024
5ea728146307ba36aa1df6e8,13107,05000US13107,Emanuel County,"Emanuel County, Georgia",22499,11105,11394
5ea728146307ba36aa1df6e9,13109,05000US13109,Evans County,"Evans County, Georgia",10727,5303,5424
5ea728146307ba36aa1df6ea,13111,05000US13111,Fannin County,"Fannin County, Georgia",24925,12086,12839
5ea728146307ba36aa1df6eb,13113,05000US13113,Fayette County,"Fayette County, Georgia",111369,54055,57314
5ea728146307ba36aa1df6ec,13115,05000US13115,Floyd County,"Floyd County, Georgia",96824,46810,50014
5ea728146307ba36aa1df6ed,13117,05000US13117,Forsyth County,"Forsyth County, Georgia",219880,109258,110622
5ea728146307ba36aa1df6ee,13119,05000US13119,Franklin County,"Franklin County, Georgia",22514,10853,11661
5ea728146307ba36aa1df6ef,13121,05000US13121,Fulton County,"Fulton County, Georgia",1021902,495087,526815
5ea728146307ba36aa1df6f0,13123,05000US13123,Gilmer County,"Gilmer County, Georgia",29922,15079,14843
5ea728146307ba36aa1df6f1,13125,05000US13125,Glascock County,"Glascock County, Georgia",3009,1438,1571
5ea728146307ba36aa1df6f2,13127,05000US13127,Glynn County,"Glynn County, Georgia",83974,39419,44555
5ea728146307ba36aa1df6f3,13129,05000US13129,Gordon County,"Gordon County, Georgia",56790,28001,28789
5ea728146307ba36aa1df6f4,13131,05000US13131,Grady County,"Grady County, Georgia",24926,12176,12750
5ea728146307ba36aa1df6f5,13133,05000US13133,Greene County,"Greene County, Georgia",16976,8299,8677
5ea728146307ba36aa1df6f6,13135,05000US13135,Gwinnett County,"Gwinnett County, Georgia",902298,441051,461247
5ea728146307ba36aa1df6f7,13137,05000US13137,Habersham County,"Habersham County, Georgia",44289,20962,23327
5ea728146307ba36aa1df6f8,13139,05000US13139,Hall County,"Hall County, Georgia",195961,97518,98443
5ea728146307ba36aa1df6f9,13141,05000US13141,Hancock County,"Hancock County, Georgia",8535,5193,3342
5ea728146307ba36aa1df6fa,13143,05000US13143,Haralson County,"Haralson County, Georgia",28956,14041,14915
5ea728146307ba36aa1df6fb,13145,05000US13145,Harris County,"Harris County, Georgia",33590,16832,16758
5ea728146307ba36aa1df6fc,13147,05000US13147,Hart County,"Hart County, Georgia",25631,12558,13073
5ea728146307ba36aa1df6fd,13149,05000US13149,Heard County,"Heard County, Georgia",11677,5747,5930
5ea728146307ba36aa1df6fe,13151,05000US13151,Henry County,"Henry County, Georgia",221307,105759,115548
5ea728146307ba36aa1df6ff,13153,05000US13153,Houston County,"Houston County, Georgia",151682,73756,77926
5ea728146307ba36aa1df700,13155,05000US13155,Irwin County,"Irwin County, Georgia",9268,4758,4510
5ea728146307ba36aa1df701,13157,05000US13157,Jackson County,"Jackson County, Georgia",65755,32445,33310
5ea728146307ba36aa1df702,13159,05000US13159,Jasper County,"Jasper County, Georgia",13784,6682,7102
5ea728146307ba36aa1df703,13161,05000US13161,Jeff Davis County,"Jeff Davis County, Georgia",14991,7408,7583
5ea728146307ba36aa1df704,13163,05000US13163,Jefferson County,"Jefferson County, Georgia",15772,7605,8167
5ea728146307ba36aa1df705,13165,05000US13165,Jenkins County,"Jenkins County, Georgia",8827,4055,4772
5ea728146307ba36aa1df706,13167,05000US13167,Johnson County,"Johnson County, Georgia",9730,5318,4412
5ea728146307ba36aa1df707,13169,05000US13169,Jones County,"Jones County, Georgia",28548,13874,14674
5ea728146307ba36aa1df708,13171,05000US13171,Lamar County,"Lamar County, Georgia",18513,8959,9554
5ea728146307ba36aa1df709,13173,05000US13173,Lanier County,"Lanier County, Georgia",10366,5183,5183
5ea728146307ba36aa1df70a,13175,05000US13175,Laurens County,"Laurens County, Georgia",47418,22497,24921
5ea728146307ba36aa1df70b,13177,05000US13177,Lee County,"Lee County, Georgia",29348,14674,14674
5ea728146307ba36aa1df70c,13179,05000US13179,Liberty County,"Liberty County, Georgia",62108,31550,30558
5ea728146307ba36aa1df70d,13181,05000US13181,Lincoln County,"Lincoln County, Georgia",7799,3683,4116
5ea728146307ba36aa1df70e,13183,05000US13183,Long County,"Long County, Georgia",18156,8872,9284
5ea728146307ba36aa1df70f,13185,05000US13185,Lowndes County,"Lowndes County, Georgia",114582,55959,58623
5ea728146307ba36aa1df710,13187,05000US13187,Lumpkin County,"Lumpkin County, Georgia",31951,15551,16400
5ea728146307ba36aa1df711,13189,05000US13189,McDuffie County,"McDuffie County, Georgia",21498,9999,11499
5ea728146307ba36aa1df712,13191,05000US13191,McIntosh County,"McIntosh County, Georgia",14120,7036,7084
5ea728146307ba36aa1df713,13193,05000US13193,Macon County,"Macon County, Georgia",13480,7342,6138
5ea728146307ba36aa1df714,13195,05000US13195,Madison County,"Madison County, Georgia",28900,14508,14392
5ea728146307ba36aa1df715,13197,05000US13197,Marion County,"Marion County, Georgia",8484,4203,4281
5ea728146307ba36aa1df716,13199,05000US13199,Meriwether County,"Meriwether County, Georgia",21113,10221,10892
5ea728146307ba36aa1df717,13201,05000US13201,Miller County,"Miller County, Georgia",5836,2832,3004
5ea728146307ba36aa1df718,13205,05000US13205,Mitchell County,"Mitchell County, Georgia",22432,11683,10749
5ea728146307ba36aa1df719,13207,05000US13207,Monroe County,"Monroe County, Georgia",27010,13600,13410
5ea728146307ba36aa1df71a,13209,05000US13209,Montgomery County,"Montgomery County, Georgia",9036,4633,4403
5ea728146307ba36aa1df71b,13211,05000US13211,Morgan County,"Morgan County, Georgia",18235,8783,9452
5ea728146307ba36aa1df71c,13213,05000US13213,Murray County,"Murray County, Georgia",39557,19522,20035
5ea728146307ba36aa1df71d,13215,05000US13215,Muscogee County,"Muscogee County, Georgia",196670,96279,100391
5ea728146307ba36aa1df71e,13217,05000US13217,Newton County,"Newton County, Georgia",106497,50598,55899
5ea728146307ba36aa1df71f,13219,05000US13219,Oconee County,"Oconee County, Georgia",37017,18164,18853
5ea728146307ba36aa1df720,13221,05000US13221,Oglethorpe County,"Oglethorpe County, Georgia",14784,7396,7388
5ea728146307ba36aa1df721,13223,05000US13223,Paulding County,"Paulding County, Georgia",155840,76195,79645
5ea728146307ba36aa1df722,13225,05000US13225,Peach County,"Peach County, Georgia",26966,12952,14014
5ea728146307ba36aa1df723,13227,05000US13227,Pickens County,"Pickens County, Georgia",30832,15233,15599
5ea728146307ba36aa1df724,13229,05000US13229,Pierce County,"Pierce County, Georgia",19164,9639,9525
5ea728146307ba36aa1df725,13231,05000US13231,Pike County,"Pike County, Georgia",18082,8876,9206
5ea728146307ba36aa1df726,13233,05000US13233,Polk County,"Polk County, Georgia",41621,20415,21206
5ea728146307ba36aa1df727,13235,05000US13235,Pulaski County,"Pulaski County, Georgia",11295,5075,6220
5ea728146307ba36aa1df728,13237,05000US13237,Putnam County,"Putnam County, Georgia",21503,10402,11101
5ea728146307ba36aa1df729,13239,05000US13239,Quitman County,"Quitman County, Georgia",2276,1081,1195
5ea728146307ba36aa1df72a,13241,05000US13241,Rabun County,"Rabun County, Georgia",16457,8107,8350
5ea728146307ba36aa1df72b,13243,05000US13243,Randolph County,"Randolph County, Georgia",7087,3493,3594
5ea728146307ba36aa1df72c,13245,05000US13245,Richmond County,"Richmond County, Georgia",201463,97272,104191
5ea728146307ba36aa1df72d,13247,05000US13247,Rockdale County,"Rockdale County, Georgia",89011,41944,47067
5ea728146307ba36aa1df72e,13249,05000US13249,Schley County,"Schley County, Georgia",5211,2546,2665
5ea728146307ba36aa1df72f,13251,05000US13251,Screven County,"Screven County, Georgia",13990,6804,7186
5ea728146307ba36aa1df730,13253,05000US13253,Seminole County,"Seminole County, Georgia",8437,4027,4410
5ea728146307ba36aa1df731,13255,05000US13255,Spalding County,"Spalding County, Georgia",64719,31395,33324
5ea728146307ba36aa1df732,13257,05000US13257,Stephens County,"Stephens County, Georgia",25676,11765,13911
5ea728146307ba36aa1df733,13259,05000US13259,Stewart County,"Stewart County, Georgia",6042,3894,2148
5ea728146307ba36aa1df734,13261,05000US13261,Sumter County,"Sumter County, Georgia",30352,14359,15993
5ea728146307ba36aa1df735,13263,05000US13263,Talbot County,"Talbot County, Georgia",6378,3032,3346
5ea728146307ba36aa1df736,13265,05000US13265,Taliaferro County,"Taliaferro County, Georgia",1665,847,818
5ea728146307ba36aa1df737,13267,05000US13267,Tattnall County,"Tattnall County, Georgia",25353,14888,10465
5ea728146307ba36aa1df738,13269,05000US13269,Taylor County,"Taylor County, Georgia",8193,3946,4247
5ea728146307ba36aa1df739,13271,05000US13271,Telfair County,"Telfair County, Georgia",16115,9346,6769
5ea728146307ba36aa1df73a,13273,05000US13273,Terrell County,"Terrell County, Georgia",8859,4228,4631
5ea728146307ba36aa1df73b,13275,05000US13275,Thomas County,"Thomas County, Georgia",44730,21219,23511
5ea728146307ba36aa1df73c,13277,05000US13277,Tift County,"Tift County, Georgia",40510,19509,21001
5ea728146307ba36aa1df73d,13279,05000US13279,Toombs County,"Toombs County, Georgia",27048,12491,14557
5ea728146307ba36aa1df73e,13281,05000US13281,Towns County,"Towns County, Georgia",11417,5334,6083
5ea728146307ba36aa1df73f,13283,05000US13283,Treutlen County,"Treutlen County, Georgia",6777,3573,3204
5ea728146307ba36aa1df740,13285,05000US13285,Troup County,"Troup County, Georgia",69774,33387,36387
5ea728146307ba36aa1df741,13287,05000US13287,Turner County,"Turner County, Georgia",7962,3843,4119
5ea728146307ba36aa1df742,13289,05000US13289,Twiggs County,"Twiggs County, Georgia",8284,4068,4216
5ea728146307ba36aa1df743,13291,05000US13291,Union County,"Union County, Georgia",22775,11048,11727
5ea728146307ba36aa1df744,13293,05000US13293,Upson County,"Upson County, Georgia",26216,12503,13713
5ea728146307ba36aa1df745,13295,05000US13295,Walker County,"Walker County, Georgia",68824,34082,34742
5ea728146307ba36aa1df746,13297,05000US13297,Walton County,"Walton County, Georgia",90132,43775,46357
5ea728146307ba36aa1df747,13299,05000US13299,Ware County,"Ware County, Georgia",35599,17753,17846
5ea728146307ba36aa1df748,13301,05000US13301,Warren County,"Warren County, Georgia",5346,2475,2871
5ea728146307ba36aa1df749,13303,05000US13303,Washington County,"Washington County, Georgia",20461,10361,10100
5ea728146307ba36aa1df74a,13305,05000US13305,Wayne County,"Wayne County, Georgia",29767,15051,14716
5ea728146307ba36aa1df74b,13307,05000US13307,Webster County,"Webster County, Georgia",2613,1254,1359
5ea728146307ba36aa1df74c,13309,05000US13309,Wheeler County,"Wheeler County, Georgia",7939,5007,2932
5ea728146307ba36aa1df74d,13311,05000US13311,White County,"White County, Georgia",28928,14128,14800
5ea728146307ba36aa1df74e,13313,05000US13313,Whitfield County,"Whitfield County, Georgia",103849,51525,52324
5ea728146307ba36aa1df74f,13315,05000US13315,Wilcox County,"Wilcox County, Georgia",8846,5242,3604
5ea728146307ba36aa1df750,13317,05000US13317,Wilkes County,"Wilkes County, Georgia",9884,4770,5114
5ea728146307ba36aa1df751,13319,05000US13319,Wilkinson County,"Wilkinson County, Georgia",9078,4349,4729
5ea728146307ba36aa1df752,13321,05000US13321,Worth County,"Worth County, Georgia",20656,10040,10616
5ea728146307ba36aa1df753,15001,05000US15001,Hawaii County,"Hawaii County, Hawaii",197658,98276,99382
5ea728146307ba36aa1df754,15003,05000US15003,Honolulu County,"Honolulu County, Hawaii",987638,497646,489992
5ea728146307ba36aa1df755,15005,05000US15005,Kalawao County,"Kalawao County, Hawaii",75,38,37
5ea728146307ba36aa1df756,15007,05000US15007,Kauai County,"Kauai County, Hawaii",71377,35375,36002
5ea728146307ba36aa1df757,15009,05000US15009,Maui County,"Maui County, Hawaii",165281,82437,82844
5ea728146307ba36aa1df758,16001,05000US16001,Ada County,"Ada County, Idaho",446052,223367,222685
5ea728146307ba36aa1df759,16003,05000US16003,Adams County,"Adams County, Idaho",4019,2093,1926
5ea728146307ba36aa1df75a,16005,05000US16005,Bannock County,"Bannock County, Idaho",85065,42300,42765
5ea728146307ba36aa1df75b,16007,05000US16007,Bear Lake County,"Bear Lake County, Idaho",5962,2898,3064
5ea728146307ba36aa1df75c,16009,05000US16009,Benewah County,"Benewah County, Idaho",9086,4607,4479
5ea728146307ba36aa1df75d,16011,05000US16011,Bingham County,"Bingham County, Idaho",45551,22746,22805
5ea728146307ba36aa1df75e,16013,05000US16013,Blaine County,"Blaine County, Idaho",21994,11251,10743
5ea728146307ba36aa1df75f,16015,05000US16015,Boise County,"Boise County, Idaho",7163,3780,3383
5ea728146307ba36aa1df760,16017,05000US16017,Bonner County,"Bonner County, Idaho",42711,21366,21345
5ea728146307ba36aa1df761,16019,05000US16019,Bonneville County,"Bonneville County, Idaho",112397,56237,56160
5ea728146307ba36aa1df762,16021,05000US16021,Boundary County,"Boundary County, Idaho",11549,5735,5814
5ea728146307ba36aa1df763,16023,05000US16023,Butte County,"Butte County, Idaho",2602,1342,1260
5ea728146307ba36aa1df764,16025,05000US16025,Camas County,"Camas County, Idaho",886,433,453
5ea728146307ba36aa1df765,16027,05000US16027,Canyon County,"Canyon County, Idaho",212230,104902,107328
5ea728146307ba36aa1df766,16029,05000US16029,Caribou County,"Caribou County, Idaho",6918,3543,3375
5ea728146307ba36aa1df767,16031,05000US16031,Cassia County,"Cassia County, Idaho",23615,12039,11576
5ea728146307ba36aa1df768,16033,05000US16033,Clark County,"Clark County, Idaho",1077,570,507
5ea728146307ba36aa1df769,16035,05000US16035,Clearwater County,"Clearwater County, Idaho",8640,4790,3850
5ea728146307ba36aa1df76a,16037,05000US16037,Custer County,"Custer County, Idaho",4141,2165,1976
5ea728146307ba36aa1df76b,16039,05000US16039,Elmore County,"Elmore County, Idaho",26433,13858,12575
5ea728146307ba36aa1df76c,16041,05000US16041,Franklin County,"Franklin County, Idaho",13279,6787,6492
5ea728146307ba36aa1df76d,16043,05000US16043,Fremont County,"Fremont County, Idaho",12965,6766,6199
5ea728146307ba36aa1df76e,16045,05000US16045,Gem County,"Gem County, Idaho",17052,8354,8698
5ea728146307ba36aa1df76f,16047,05000US16047,Gooding County,"Gooding County, Idaho",15169,7911,7258
5ea728146307ba36aa1df770,16049,05000US16049,Idaho County,"Idaho County, Idaho",16337,8537,7800
5ea728146307ba36aa1df771,16051,05000US16051,Jefferson County,"Jefferson County, Idaho",27969,14295,13674
5ea728146307ba36aa1df772,16053,05000US16053,Jerome County,"Jerome County, Idaho",23431,11801,11630
5ea728146307ba36aa1df773,16055,05000US16055,Kootenai County,"Kootenai County, Idaho",153605,75890,77715
5ea728146307ba36aa1df774,16057,05000US16057,Latah County,"Latah County, Idaho",39239,19894,19345
5ea728146307ba36aa1df775,16059,05000US16059,Lemhi County,"Lemhi County, Idaho",7798,3948,3850
5ea728146307ba36aa1df776,16061,05000US16061,Lewis County,"Lewis County, Idaho",3845,1911,1934
5ea728146307ba36aa1df777,16063,05000US16063,Lincoln County,"Lincoln County, Idaho",5321,2766,2555
5ea728146307ba36aa1df778,16065,05000US16065,Madison County,"Madison County, Idaho",38705,19529,19176
5ea728146307ba36aa1df779,16067,05000US16067,Minidoka County,"Minidoka County, Idaho",20615,10377,10238
5ea728146307ba36aa1df77a,16069,05000US16069,Nez Perce County,"Nez Perce County, Idaho",40155,19758,20397
5ea728146307ba36aa1df77b,16071,05000US16071,Oneida County,"Oneida County, Idaho",4326,2083,2243
5ea728146307ba36aa1df77c,16073,05000US16073,Owyhee County,"Owyhee County, Idaho",11455,5874,5581
5ea728146307ba36aa1df77d,16075,05000US16075,Payette County,"Payette County, Idaho",23041,11470,11571
5ea728146307ba36aa1df77e,16077,05000US16077,Power County,"Power County, Idaho",7713,3781,3932
5ea728146307ba36aa1df77f,16079,05000US16079,Shoshone County,"Shoshone County, Idaho",12526,6267,6259
5ea728146307ba36aa1df780,16081,05000US16081,Teton County,"Teton County, Idaho",11080,5887,5193
5ea728146307ba36aa1df781,16083,05000US16083,Twin Falls County,"Twin Falls County, Idaho",83666,41204,42462
5ea728146307ba36aa1df782,16085,05000US16085,Valley County,"Valley County, Idaho",10401,5486,4915
5ea728146307ba36aa1df783,16087,05000US16087,Washington County,"Washington County, Idaho",10025,4966,5059
5ea728146307ba36aa1df784,17001,05000US17001,Adams County,"Adams County, Illinois",66427,32481,33946
5ea728146307ba36aa1df785,17003,05000US17003,Alexander County,"Alexander County, Illinois",6532,3104,3428
5ea728146307ba36aa1df786,17005,05000US17005,Bond County,"Bond County, Illinois",16712,8587,8125
5ea728146307ba36aa1df787,17007,05000US17007,Boone County,"Boone County, Illinois",53606,26830,26776
5ea728146307ba36aa1df788,17009,05000US17009,Brown County,"Brown County, Illinois",6675,4238,2437
5ea728146307ba36aa1df789,17011,05000US17011,Bureau County,"Bureau County, Illinois",33381,16437,16944
5ea728146307ba36aa1df78a,17013,05000US17013,Calhoun County,"Calhoun County, Illinois",4858,2435,2423
5ea728146307ba36aa1df78b,17015,05000US17015,Carroll County,"Carroll County, Illinois",14562,7229,7333
5ea728146307ba36aa1df78c,17017,05000US17017,Cass County,"Cass County, Illinois",12665,6353,6312
5ea728146307ba36aa1df78d,17019,05000US17019,Champaign County,"Champaign County, Illinois",209448,104513,104935
5ea728146307ba36aa1df78e,17021,05000US17021,Christian County,"Christian County, Illinois",33231,16818,16413
5ea728146307ba36aa1df78f,17023,05000US17023,Clark County,"Clark County, Illinois",15836,7824,8012
5ea728146307ba36aa1df790,17025,05000US17025,Clay County,"Clay County, Illinois",13338,6586,6752
5ea728146307ba36aa1df791,17027,05000US17027,Clinton County,"Clinton County, Illinois",37628,19551,18077
5ea728146307ba36aa1df792,17029,05000US17029,Coles County,"Coles County, Illinois",51736,24999,26737
5ea728146307ba36aa1df793,17031,05000US17031,Cook County,"Cook County, Illinois",5223719,2534640,2689079
5ea728146307ba36aa1df794,17033,05000US17033,Crawford County,"Crawford County, Illinois",19088,9910,9178
5ea728146307ba36aa1df795,17035,05000US17035,Cumberland County,"Cumberland County, Illinois",10865,5455,5410
5ea728146307ba36aa1df796,17037,05000US17037,DeKalb County,"DeKalb County, Illinois",104200,51580,52620
5ea728146307ba36aa1df797,17039,05000US17039,De Witt County,"De Witt County, Illinois",16042,8015,8027
5ea728146307ba36aa1df798,17041,05000US17041,Douglas County,"Douglas County, Illinois",19714,9748,9966
5ea728146307ba36aa1df799,17043,05000US17043,DuPage County,"DuPage County, Illinois",931743,457178,474565
5ea728146307ba36aa1df79a,17045,05000US17045,Edgar County,"Edgar County, Illinois",17539,8617,8922
5ea728146307ba36aa1df79b,17047,05000US17047,Edwards County,"Edwards County, Illinois",6507,3231,3276
5ea728146307ba36aa1df79c,17049,05000US17049,Effingham County,"Effingham County, Illinois",34174,16971,17203
5ea728146307ba36aa1df79d,17051,05000US17051,Fayette County,"Fayette County, Illinois",21724,11580,10144
5ea728146307ba36aa1df79e,17053,05000US17053,Ford County,"Ford County, Illinois",13398,6616,6782
5ea728146307ba36aa1df79f,17055,05000US17055,Franklin County,"Franklin County, Illinois",39127,19285,19842
5ea728146307ba36aa1df7a0,17057,05000US17057,Fulton County,"Fulton County, Illinois",35418,18496,16922
5ea728146307ba36aa1df7a1,17059,05000US17059,Gallatin County,"Gallatin County, Illinois",5157,2472,2685
5ea728146307ba36aa1df7a2,17061,05000US17061,Greene County,"Greene County, Illinois",13218,6668,6550
5ea728146307ba36aa1df7a3,17063,05000US17063,Grundy County,"Grundy County, Illinois",50509,25241,25268
5ea728146307ba36aa1df7a4,17065,05000US17065,Hamilton County,"Hamilton County, Illinois",8221,4018,4203
5ea728146307ba36aa1df7a5,17067,05000US17067,Hancock County,"Hancock County, Illinois",18112,9008,9104
5ea728146307ba36aa1df7a6,17069,05000US17069,Hardin County,"Hardin County, Illinois",4009,1976,2033
5ea728146307ba36aa1df7a7,17071,05000US17071,Henderson County,"Henderson County, Illinois",6884,3369,3515
5ea728146307ba36aa1df7a8,17073,05000US17073,Henry County,"Henry County, Illinois",49464,24536,24928
5ea728146307ba36aa1df7a9,17075,05000US17075,Iroquois County,"Iroquois County, Illinois",28169,13751,14418
5ea728146307ba36aa1df7aa,17077,05000US17077,Jackson County,"Jackson County, Illinois",58551,28989,29562
5ea728146307ba36aa1df7ab,17079,05000US17079,Jasper County,"Jasper County, Illinois",9598,4809,4789
5ea728146307ba36aa1df7ac,17081,05000US17081,Jefferson County,"Jefferson County, Illinois",38169,19567,18602
5ea728146307ba36aa1df7ad,17083,05000US17083,Jersey County,"Jersey County, Illinois",22069,10841,11228
5ea728146307ba36aa1df7ae,17085,05000US17085,Jo Daviess County,"Jo Daviess County, Illinois",21834,10956,10878
5ea728146307ba36aa1df7af,17087,05000US17087,Johnson County,"Johnson County, Illinois",12602,7015,5587
5ea728146307ba36aa1df7b0,17089,05000US17089,Kane County,"Kane County, Illinois",530839,264211,266628
5ea728146307ba36aa1df7b1,17091,05000US17091,Kankakee County,"Kankakee County, Illinois",111061,54615,56446
5ea728146307ba36aa1df7b2,17093,05000US17093,Kendall County,"Kendall County, Illinois",124626,61761,62865
5ea728146307ba36aa1df7b3,17095,05000US17095,Knox County,"Knox County, Illinois",50999,25743,25256
5ea728146307ba36aa1df7b4,17097,05000US17097,Lake County,"Lake County, Illinois",703619,351343,352276
5ea728146307ba36aa1df7b5,17099,05000US17099,LaSalle County,"LaSalle County, Illinois",110401,55400,55001
5ea728146307ba36aa1df7b6,17101,05000US17101,Lawrence County,"Lawrence County, Illinois",16189,8919,7270
5ea728146307ba36aa1df7b7,17103,05000US17103,Lee County,"Lee County, Illinois",34527,18326,16201
5ea728146307ba36aa1df7b8,17105,05000US17105,Livingston County,"Livingston County, Illinois",36324,18614,17710
5ea728146307ba36aa1df7b9,17107,05000US17107,Logan County,"Logan County, Illinois",29207,14183,15024
5ea728146307ba36aa1df7ba,17109,05000US17109,McDonough County,"McDonough County, Illinois",30875,15009,15866
5ea728146307ba36aa1df7bb,17111,05000US17111,McHenry County,"McHenry County, Illinois",307789,153382,154407
5ea728146307ba36aa1df7bc,17113,05000US17113,McLean County,"McLean County, Illinois",173219,84245,88974
5ea728146307ba36aa1df7bd,17115,05000US17115,Macon County,"Macon County, Illinois",106512,51062,55450
5ea728146307ba36aa1df7be,17117,05000US17117,Macoupin County,"Macoupin County, Illinois",45719,22602,23117
5ea728146307ba36aa1df7bf,17119,05000US17119,Madison County,"Madison County, Illinois",265670,129718,135952
5ea728146307ba36aa1df7c0,17121,05000US17121,Marion County,"Marion County, Illinois",38084,18726,19358
5ea728146307ba36aa1df7c1,17123,05000US17123,Marshall County,"Marshall County, Illinois",11794,5874,5920
5ea728146307ba36aa1df7c2,17125,05000US17125,Mason County,"Mason County, Illinois",13778,6838,6940
5ea728146307ba36aa1df7c3,17127,05000US17127,Massac County,"Massac County, Illinois",14430,6794,7636
5ea728146307ba36aa1df7c4,17129,05000US17129,Menard County,"Menard County, Illinois",12367,6043,6324
5ea728146307ba36aa1df7c5,17131,05000US17131,Mercer County,"Mercer County, Illinois",15693,7798,7895
5ea728146307ba36aa1df7c6,17133,05000US17133,Monroe County,"Monroe County, Illinois",33936,16691,17245
5ea728146307ba36aa1df7c7,17135,05000US17135,Montgomery County,"Montgomery County, Illinois",29009,15145,13864
5ea728146307ba36aa1df7c8,17137,05000US17137,Morgan County,"Morgan County, Illinois",34426,17298,17128
5ea728146307ba36aa1df7c9,17139,05000US17139,Moultrie County,"Moultrie County, Illinois",14703,7172,7531
5ea728146307ba36aa1df7ca,17141,05000US17141,Ogle County,"Ogle County, Illinois",51328,25614,25714
5ea728146307ba36aa1df7cb,17143,05000US17143,Peoria County,"Peoria County, Illinois",184463,89387,95076
5ea728146307ba36aa1df7cc,17145,05000US17145,Perry County,"Perry County, Illinois",21384,11767,9617
5ea728146307ba36aa1df7cd,17147,05000US17147,Piatt County,"Piatt County, Illinois",16427,8080,8347
5ea728146307ba36aa1df7ce,17149,05000US17149,Pike County,"Pike County, Illinois",15754,7815,7939
5ea728146307ba36aa1df7cf,17151,05000US17151,Pope County,"Pope County, Illinois",4249,2349,1900
5ea728146307ba36aa1df7d0,17153,05000US17153,Pulaski County,"Pulaski County, Illinois",5611,2747,2864
5ea728146307ba36aa1df7d1,17155,05000US17155,Putnam County,"Putnam County, Illinois",5746,2959,2787
5ea728146307ba36aa1df7d2,17157,05000US17157,Randolph County,"Randolph County, Illinois",32546,18019,14527
5ea728146307ba36aa1df7d3,17159,05000US17159,Richland County,"Richland County, Illinois",15881,7809,8072
5ea728146307ba36aa1df7d4,17161,05000US17161,Rock Island County,"Rock Island County, Illinois",145275,71596,73679
5ea728146307ba36aa1df7d5,17163,05000US17163,St. Clair County,"St. Clair County, Illinois",263463,127237,136226
5ea728146307ba36aa1df7d6,17165,05000US17165,Saline County,"Saline County, Illinois",24231,11962,12269
5ea728146307ba36aa1df7d7,17167,05000US17167,Sangamon County,"Sangamon County, Illinois",197661,94876,102785
5ea728146307ba36aa1df7d8,17169,05000US17169,Schuyler County,"Schuyler County, Illinois",7064,3701,3363
5ea728146307ba36aa1df7d9,17171,05000US17171,Scott County,"Scott County, Illinois",5047,2460,2587
5ea728146307ba36aa1df7da,17173,05000US17173,Shelby County,"Shelby County, Illinois",21832,10791,11041
5ea728146307ba36aa1df7db,17175,05000US17175,Stark County,"Stark County, Illinois",5500,2716,2784
5ea728146307ba36aa1df7dc,17177,05000US17177,Stephenson County,"Stephenson County, Illinois",45433,21986,23447
5ea728146307ba36aa1df7dd,17179,05000US17179,Tazewell County,"Tazewell County, Illinois",133852,65987,67865
5ea728146307ba36aa1df7de,17181,05000US17181,Union County,"Union County, Illinois",17127,8592,8535
5ea728146307ba36aa1df7df,17183,05000US17183,Vermilion County,"Vermilion County, Illinois",78407,38967,39440
5ea728146307ba36aa1df7e0,17185,05000US17185,Wabash County,"Wabash County, Illinois",11573,5666,5907
5ea728146307ba36aa1df7e1,17187,05000US17187,Warren County,"Warren County, Illinois",17338,8353,8985
5ea728146307ba36aa1df7e2,17189,05000US17189,Washington County,"Washington County, Illinois",14155,7108,7047
5ea728146307ba36aa1df7e3,17191,05000US17191,Wayne County,"Wayne County, Illinois",16487,8141,8346
5ea728146307ba36aa1df7e4,17193,05000US17193,White County,"White County, Illinois",14025,6882,7143
5ea728146307ba36aa1df7e5,17195,05000US17195,Whiteside County,"Whiteside County, Illinois",56396,27799,28597
5ea728146307ba36aa1df7e6,17197,05000US17197,Will County,"Will County, Illinois",688697,341816,346881
5ea728146307ba36aa1df7e7,17199,05000US17199,Williamson County,"Williamson County, Illinois",67299,33607,33692
5ea728146307ba36aa1df7e8,17201,05000US17201,Winnebago County,"Winnebago County, Illinois",286174,139748,146426
5ea728146307ba36aa1df7e9,17203,05000US17203,Woodford County,"Woodford County, Illinois",38817,19343,19474
5ea728146307ba36aa1df7ea,18001,05000US18001,Adams County,"Adams County, Indiana",35195,17561,17634
5ea728146307ba36aa1df7eb,18003,05000US18003,Allen County,"Allen County, Indiana",370016,180669,189347
5ea728146307ba36aa1df7ec,18005,05000US18005,Bartholomew County,"Bartholomew County, Indiana",81893,41150,40743
5ea728146307ba36aa1df7ed,18007,05000US18007,Benton County,"Benton County, Indiana",8667,4326,4341
5ea728146307ba36aa1df7ee,18009,05000US18009,Blackford County,"Blackford County, Indiana",12129,6037,6092
5ea728146307ba36aa1df7ef,18011,05000US18011,Boone County,"Boone County, Indiana",64321,31750,32571
5ea728146307ba36aa1df7f0,18013,05000US18013,Brown County,"Brown County, Indiana",15034,7441,7593
5ea728146307ba36aa1df7f1,18015,05000US18015,Carroll County,"Carroll County, Indiana",19994,10034,9960
5ea728146307ba36aa1df7f2,18017,05000US18017,Cass County,"Cass County, Indiana",38084,19082,19002
5ea728146307ba36aa1df7f3,18019,05000US18019,Clark County,"Clark County, Indiana",115702,56359,59343
5ea728146307ba36aa1df7f4,18021,05000US18021,Clay County,"Clay County, Indiana",26268,12935,13333
5ea728146307ba36aa1df7f5,18023,05000US18023,Clinton County,"Clinton County, Indiana",32301,15986,16315
5ea728146307ba36aa1df7f6,18025,05000US18025,Crawford County,"Crawford County, Indiana",10581,5367,5214
5ea728146307ba36aa1df7f7,18027,05000US18027,Daviess County,"Daviess County, Indiana",32937,16634,16303
5ea728146307ba36aa1df7f8,18029,05000US18029,Dearborn County,"Dearborn County, Indiana",49501,24764,24737
5ea728146307ba36aa1df7f9,18031,05000US18031,Decatur County,"Decatur County, Indiana",26552,13202,13350
5ea728146307ba36aa1df7fa,18033,05000US18033,DeKalb County,"DeKalb County, Indiana",42704,21307,21397
5ea728146307ba36aa1df7fb,18035,05000US18035,Delaware County,"Delaware County, Indiana",115616,55743,59873
5ea728146307ba36aa1df7fc,18037,05000US18037,Dubois County,"Dubois County, Indiana",42418,21048,21370
5ea728146307ba36aa1df7fd,18039,05000US18039,Elkhart County,"Elkhart County, Indiana",203604,100713,102891
5ea728146307ba36aa1df7fe,18041,05000US18041,Fayette County,"Fayette County, Indiana",23259,11474,11785
5ea728146307ba36aa1df7ff,18043,05000US18043,Floyd County,"Floyd County, Indiana",76809,37135,39674
5ea728146307ba36aa1df800,18045,05000US18045,Fountain County,"Fountain County, Indiana",16486,8251,8235
5ea728146307ba36aa1df801,18047,05000US18047,Franklin County,"Franklin County, Indiana",22842,11426,11416
5ea728146307ba36aa1df802,18049,05000US18049,Fulton County,"Fulton County, Indiana",20212,9962,10250
5ea728146307ba36aa1df803,18051,05000US18051,Gibson County,"Gibson County, Indiana",33596,16848,16748
5ea728146307ba36aa1df804,18053,05000US18053,Grant County,"Grant County, Indiana",66944,31935,35009
5ea728146307ba36aa1df805,18055,05000US18055,Greene County,"Greene County, Indiana",32295,16033,16262
5ea728146307ba36aa1df806,18057,05000US18057,Hamilton County,"Hamilton County, Indiana",316095,154532,161563
5ea728146307ba36aa1df807,18059,05000US18059,Hancock County,"Hancock County, Indiana",73830,36255,37575
5ea728146307ba36aa1df808,18061,05000US18061,Harrison County,"Harrison County, Indiana",39712,19875,19837
5ea728146307ba36aa1df809,18063,05000US18063,Hendricks County,"Hendricks County, Indiana",160940,80391,80549
5ea728146307ba36aa1df80a,18065,05000US18065,Henry County,"Henry County, Indiana",48483,25391,23092
5ea728146307ba36aa1df80b,18067,05000US18067,Howard County,"Howard County, Indiana",82387,39852,42535
5ea728146307ba36aa1df80c,18069,05000US18069,Huntington County,"Huntington County, Indiana",36378,17875,18503
5ea728146307ba36aa1df80d,18071,05000US18071,Jackson County,"Jackson County, Indiana",43938,21822,22116
5ea728146307ba36aa1df80e,18073,05000US18073,Jasper County,"Jasper County, Indiana",33449,16699,16750
5ea728146307ba36aa1df80f,18075,05000US18075,Jay County,"Jay County, Indiana",20993,10398,10595
5ea728146307ba36aa1df810,18077,05000US18077,Jefferson County,"Jefferson County, Indiana",32237,15333,16904
5ea728146307ba36aa1df811,18079,05000US18079,Jennings County,"Jennings County, Indiana",27727,13925,13802
5ea728146307ba36aa1df812,18081,05000US18081,Johnson County,"Johnson County, Indiana",151564,74349,77215
5ea728146307ba36aa1df813,18083,05000US18083,Knox County,"Knox County, Indiana",37409,18949,18460
5ea728146307ba36aa1df814,18085,05000US18085,Kosciusko County,"Kosciusko County, Indiana",78806,39264,39542
5ea728146307ba36aa1df815,18087,05000US18087,LaGrange County,"LaGrange County, Indiana",38942,19752,19190
5ea728146307ba36aa1df816,18089,05000US18089,Lake County,"Lake County, Indiana",486849,235515,251334
5ea728146307ba36aa1df817,18091,05000US18091,LaPorte County,"LaPorte County, Indiana",110552,57068,53484
5ea728146307ba36aa1df818,18093,05000US18093,Lawrence County,"Lawrence County, Indiana",45619,22558,23061
5ea728146307ba36aa1df819,18095,05000US18095,Madison County,"Madison County, Indiana",129505,64707,64798
5ea728146307ba36aa1df81a,18097,05000US18097,Marion County,"Marion County, Indiana",944523,455007,489516
5ea728146307ba36aa1df81b,18099,05000US18099,Marshall County,"Marshall County, Indiana",46595,23174,23421
5ea728146307ba36aa1df81c,18101,05000US18101,Martin County,"Martin County, Indiana",10210,5155,5055
5ea728146307ba36aa1df81d,18103,05000US18103,Miami County,"Miami County, Indiana",35901,19084,16817
5ea728146307ba36aa1df81e,18105,05000US18105,Monroe County,"Monroe County, Indiana",145403,72416,72987
5ea728146307ba36aa1df81f,18107,05000US18107,Montgomery County,"Montgomery County, Indiana",38276,19442,18834
5ea728146307ba36aa1df820,18109,05000US18109,Morgan County,"Morgan County, Indiana",69727,34447,35280
5ea728146307ba36aa1df821,18111,05000US18111,Newton County,"Newton County, Indiana",14018,7004,7014
5ea728146307ba36aa1df822,18113,05000US18113,Noble County,"Noble County, Indiana",47451,23844,23607
5ea728146307ba36aa1df823,18115,05000US18115,Ohio County,"Ohio County, Indiana",5887,2918,2969
5ea728146307ba36aa1df824,18117,05000US18117,Orange County,"Orange County, Indiana",19547,9727,9820
5ea728146307ba36aa1df825,18119,05000US18119,Owen County,"Owen County, Indiana",20878,10628,10250
5ea728146307ba36aa1df826,18121,05000US18121,Parke County,"Parke County, Indiana",16996,8211,8785
5ea728146307ba36aa1df827,18123,05000US18123,Perry County,"Perry County, Indiana",19141,10222,8919
5ea728146307ba36aa1df828,18125,05000US18125,Pike County,"Pike County, Indiana",12411,6256,6155
5ea728146307ba36aa1df829,18127,05000US18127,Porter County,"Porter County, Indiana",168041,83212,84829
5ea728146307ba36aa1df82a,18129,05000US18129,Posey County,"Posey County, Indiana",25589,12787,12802
5ea728146307ba36aa1df82b,18131,05000US18131,Pulaski County,"Pulaski County, Indiana",12660,6404,6256
5ea728146307ba36aa1df82c,18133,05000US18133,Putnam County,"Putnam County, Indiana",37559,19714,17845
5ea728146307ba36aa1df82d,18135,05000US18135,Randolph County,"Randolph County, Indiana",25076,12269,12807
5ea728146307ba36aa1df82e,18137,05000US18137,Ripley County,"Ripley County, Indiana",28425,14077,14348
5ea728146307ba36aa1df82f,18139,05000US18139,Rush County,"Rush County, Indiana",16704,8185,8519
5ea728146307ba36aa1df830,18141,05000US18141,St. Joseph County,"St. Joseph County, Indiana",269240,130832,138408
5ea728146307ba36aa1df831,18143,05000US18143,Scott County,"Scott County, Indiana",23743,11670,12073
5ea728146307ba36aa1df832,18145,05000US18145,Shelby County,"Shelby County, Indiana",44399,21941,22458
5ea728146307ba36aa1df833,18147,05000US18147,Spencer County,"Spencer County, Indiana",20526,10363,10163
5ea728146307ba36aa1df834,18149,05000US18149,Starke County,"Starke County, Indiana",22941,11302,11639
5ea728146307ba36aa1df835,18151,05000US18151,Steuben County,"Steuben County, Indiana",34474,17542,16932
5ea728146307ba36aa1df836,18153,05000US18153,Sullivan County,"Sullivan County, Indiana",20792,11174,9618
5ea728146307ba36aa1df837,18155,05000US18155,Switzerland County,"Switzerland County, Indiana",10628,5504,5124
5ea728146307ba36aa1df838,18157,05000US18157,Tippecanoe County,"Tippecanoe County, Indiana",189294,96866,92428
5ea728146307ba36aa1df839,18159,05000US18159,Tipton County,"Tipton County, Indiana",15218,7609,7609
5ea728146307ba36aa1df83a,18161,05000US18161,Union County,"Union County, Indiana",7153,3514,3639
5ea728146307ba36aa1df83b,18163,05000US18163,Vanderburgh County,"Vanderburgh County, Indiana",181313,87676,93637
5ea728146307ba36aa1df83c,18165,05000US18165,Vermillion County,"Vermillion County, Indiana",15560,7809,7751
5ea728146307ba36aa1df83d,18167,05000US18167,Vigo County,"Vigo County, Indiana",107693,54705,52988
5ea728146307ba36aa1df83e,18169,05000US18169,Wabash County,"Wabash County, Indiana",31631,15365,16266
5ea728146307ba36aa1df83f,18171,05000US18171,Warren County,"Warren County, Indiana",8247,4124,4123
5ea728146307ba36aa1df840,18173,05000US18173,Warrick County,"Warrick County, Indiana",61928,30409,31519
5ea728146307ba36aa1df841,18175,05000US18175,Washington County,"Washington County, Indiana",27827,13892,13935
5ea728146307ba36aa1df842,18177,05000US18177,Wayne County,"Wayne County, Indiana",66613,32288,34325
5ea728146307ba36aa1df843,18179,05000US18179,Wells County,"Wells County, Indiana",27947,13773,14174
5ea728146307ba36aa1df844,18181,05000US18181,White County,"White County, Indiana",24217,12143,12074
5ea728146307ba36aa1df845,18183,05000US18183,Whitley County,"Whitley County, Indiana",33649,16702,16947
5ea728146307ba36aa1df846,19001,05000US19001,Adair County,"Adair County, Iowa",7124,3516,3608
5ea728146307ba36aa1df847,19003,05000US19003,Adams County,"Adams County, Iowa",3726,1854,1872
5ea728146307ba36aa1df848,19005,05000US19005,Allamakee County,"Allamakee County, Iowa",13880,7045,6835
5ea728146307ba36aa1df849,19007,05000US19007,Appanoose County,"Appanoose County, Iowa",12510,6154,6356
5ea728146307ba36aa1df84a,19009,05000US19009,Audubon County,"Audubon County, Iowa",5637,2758,2879
5ea728146307ba36aa1df84b,19011,05000US19011,Benton County,"Benton County, Iowa",25626,12783,12843
5ea728146307ba36aa1df84c,19013,05000US19013,Black Hawk County,"Black Hawk County, Iowa",133009,65309,67700
5ea728146307ba36aa1df84d,19015,05000US19015,Boone County,"Boone County, Iowa",26399,13310,13089
5ea728146307ba36aa1df84e,19017,05000US19017,Bremer County,"Bremer County, Iowa",24782,12274,12508
5ea728146307ba36aa1df84f,19019,05000US19019,Buchanan County,"Buchanan County, Iowa",21125,10451,10674
5ea728146307ba36aa1df850,19021,05000US19021,Buena Vista County,"Buena Vista County, Iowa",20260,10238,10022
5ea728146307ba36aa1df851,19023,05000US19023,Butler County,"Butler County, Iowa",14735,7381,7354
5ea728146307ba36aa1df852,19025,05000US19025,Calhoun County,"Calhoun County, Iowa",9780,5044,4736
5ea728146307ba36aa1df853,19027,05000US19027,Carroll County,"Carroll County, Iowa",20344,9988,10356
5ea728146307ba36aa1df854,19029,05000US19029,Cass County,"Cass County, Iowa",13191,6547,6644
5ea728146307ba36aa1df855,19031,05000US19031,Cedar County,"Cedar County, Iowa",18445,9161,9284
5ea728146307ba36aa1df856,19033,05000US19033,Cerro Gordo County,"Cerro Gordo County, Iowa",42984,20850,22134
5ea728146307ba36aa1df857,19035,05000US19035,Cherokee County,"Cherokee County, Iowa",11468,5796,5672
5ea728146307ba36aa1df858,19037,05000US19037,Chickasaw County,"Chickasaw County, Iowa",12099,6058,6041
5ea728146307ba36aa1df859,19039,05000US19039,Clarke County,"Clarke County, Iowa",9282,4689,4593
5ea728146307ba36aa1df85a,19041,05000US19041,Clay County,"Clay County, Iowa",16313,8051,8262
5ea728146307ba36aa1df85b,19043,05000US19043,Clayton County,"Clayton County, Iowa",17672,8900,8772
5ea728146307ba36aa1df85c,19045,05000US19045,Clinton County,"Clinton County, Iowa",47218,23126,24092
5ea728146307ba36aa1df85d,19047,05000US19047,Crawford County,"Crawford County, Iowa",17132,8547,8585
5ea728146307ba36aa1df85e,19049,05000US19049,Dallas County,"Dallas County, Iowa",84002,41367,42635
5ea728146307ba36aa1df85f,19051,05000US19051,Davis County,"Davis County, Iowa",8885,4398,4487
5ea728146307ba36aa1df860,19053,05000US19053,Decatur County,"Decatur County, Iowa",8044,4017,4027
5ea728146307ba36aa1df861,19055,05000US19055,Delaware County,"Delaware County, Iowa",17258,8689,8569
5ea728146307ba36aa1df862,19057,05000US19057,Des Moines County,"Des Moines County, Iowa",39600,19313,20287
5ea728146307ba36aa1df863,19059,05000US19059,Dickinson County,"Dickinson County, Iowa",17056,8515,8541
5ea728146307ba36aa1df864,19061,05000US19061,Dubuque County,"Dubuque County, Iowa",96802,47744,49058
5ea728146307ba36aa1df865,19063,05000US19063,Emmet County,"Emmet County, Iowa",9551,4770,4781
5ea728146307ba36aa1df866,19065,05000US19065,Fayette County,"Fayette County, Iowa",19929,9998,9931
5ea728146307ba36aa1df867,19067,05000US19067,Floyd County,"Floyd County, Iowa",15858,7766,8092
5ea728146307ba36aa1df868,19069,05000US19069,Franklin County,"Franklin County, Iowa",10245,5117,5128
5ea728146307ba36aa1df869,19071,05000US19071,Fremont County,"Fremont County, Iowa",6968,3470,3498
5ea728146307ba36aa1df86a,19073,05000US19073,Greene County,"Greene County, Iowa",9003,4380,4623
5ea728146307ba36aa1df86b,19075,05000US19075,Grundy County,"Grundy County, Iowa",12341,6108,6233
5ea728146307ba36aa1df86c,19077,05000US19077,Guthrie County,"Guthrie County, Iowa",10674,5335,5339
5ea728146307ba36aa1df86d,19079,05000US19079,Hamilton County,"Hamilton County, Iowa",15110,7377,7733
5ea728146307ba36aa1df86e,19081,05000US19081,Hancock County,"Hancock County, Iowa",10888,5494,5394
5ea728146307ba36aa1df86f,19083,05000US19083,Hardin County,"Hardin County, Iowa",17127,8565,8562
5ea728146307ba36aa1df870,19085,05000US19085,Harrison County,"Harrison County, Iowa",14143,6989,7154
5ea728146307ba36aa1df871,19087,05000US19087,Henry County,"Henry County, Iowa",19926,10125,9801
5ea728146307ba36aa1df872,19089,05000US19089,Howard County,"Howard County, Iowa",9264,4580,4684
5ea728146307ba36aa1df873,19091,05000US19091,Humboldt County,"Humboldt County, Iowa",9566,4651,4915
5ea728146307ba36aa1df874,19093,05000US19093,Ida County,"Ida County, Iowa",6916,3457,3459
5ea728146307ba36aa1df875,19095,05000US19095,Iowa County,"Iowa County, Iowa",16207,8052,8155
5ea728146307ba36aa1df876,19097,05000US19097,Jackson County,"Jackson County, Iowa",19395,9712,9683
5ea728146307ba36aa1df877,19099,05000US19099,Jasper County,"Jasper County, Iowa",36891,18669,18222
5ea728146307ba36aa1df878,19101,05000US19101,Jefferson County,"Jefferson County, Iowa",18077,9112,8965
5ea728146307ba36aa1df879,19103,05000US19103,Johnson County,"Johnson County, Iowa",147001,72765,74236
5ea728146307ba36aa1df87a,19105,05000US19105,Jones County,"Jones County, Iowa",20568,10585,9983
5ea728146307ba36aa1df87b,19107,05000US19107,Keokuk County,"Keokuk County, Iowa",10200,5202,4998
5ea728146307ba36aa1df87c,19109,05000US19109,Kossuth County,"Kossuth County, Iowa",15075,7547,7528
5ea728146307ba36aa1df87d,19111,05000US19111,Lee County,"Lee County, Iowa",34541,17371,17170
5ea728146307ba36aa1df87e,19113,05000US19113,Linn County,"Linn County, Iowa",222121,109540,112581
5ea728146307ba36aa1df87f,19115,05000US19115,Louisa County,"Louisa County, Iowa",11223,5724,5499
5ea728146307ba36aa1df880,19117,05000US19117,Lucas County,"Lucas County, Iowa",8597,4318,4279
5ea728146307ba36aa1df881,19119,05000US19119,Lyon County,"Lyon County, Iowa",11769,6013,5756
5ea728146307ba36aa1df882,19121,05000US19121,Madison County,"Madison County, Iowa",15890,8028,7862
5ea728146307ba36aa1df883,19123,05000US19123,Mahaska County,"Mahaska County, Iowa",22208,11252,10956
5ea728146307ba36aa1df884,19125,05000US19125,Marion County,"Marion County, Iowa",33207,16374,16833
5ea728146307ba36aa1df885,19127,05000US19127,Marshall County,"Marshall County, Iowa",40271,20400,19871
5ea728146307ba36aa1df886,19129,05000US19129,Mills County,"Mills County, Iowa",14957,7516,7441
5ea728146307ba36aa1df887,19131,05000US19131,Mitchell County,"Mitchell County, Iowa",10631,5282,5349
5ea728146307ba36aa1df888,19133,05000US19133,Monona County,"Monona County, Iowa",8796,4283,4513
5ea728146307ba36aa1df889,19135,05000US19135,Monroe County,"Monroe County, Iowa",7863,4064,3799
5ea728146307ba36aa1df88a,19137,05000US19137,Montgomery County,"Montgomery County, Iowa",10155,4869,5286
5ea728146307ba36aa1df88b,19139,05000US19139,Muscatine County,"Muscatine County, Iowa",42950,21476,21474
5ea728146307ba36aa1df88c,19141,05000US19141,O'Brien County,"O'Brien County, Iowa",13911,6962,6949
5ea728146307ba36aa1df88d,19143,05000US19143,Osceola County,"Osceola County, Iowa",6115,3091,3024
5ea728146307ba36aa1df88e,19145,05000US19145,Page County,"Page County, Iowa",15363,7922,7441
5ea728146307ba36aa1df88f,19147,05000US19147,Palo Alto County,"Palo Alto County, Iowa",9055,4512,4543
5ea728146307ba36aa1df890,19149,05000US19149,Plymouth County,"Plymouth County, Iowa",25039,12288,12751
5ea728146307ba36aa1df891,19151,05000US19151,Pocahontas County,"Pocahontas County, Iowa",6898,3384,3514
5ea728146307ba36aa1df892,19153,05000US19153,Polk County,"Polk County, Iowa",474274,233599,240675
5ea728146307ba36aa1df893,19155,05000US19155,Pottawattamie County,"Pottawattamie County, Iowa",93503,45923,47580
5ea728146307ba36aa1df894,19157,05000US19157,Poweshiek County,"Poweshiek County, Iowa",18605,8990,9615
5ea728146307ba36aa1df895,19159,05000US19159,Ringgold County,"Ringgold County, Iowa",4984,2432,2552
5ea728146307ba36aa1df896,19161,05000US19161,Sac County,"Sac County, Iowa",9868,4818,5050
5ea728146307ba36aa1df897,19163,05000US19163,Scott County,"Scott County, Iowa",172288,84515,87773
5ea728146307ba36aa1df898,19165,05000US19165,Shelby County,"Shelby County, Iowa",11694,5735,5959
5ea728146307ba36aa1df899,19167,05000US19167,Sioux County,"Sioux County, Iowa",34825,17487,17338
5ea728146307ba36aa1df89a,19169,05000US19169,Story County,"Story County, Iowa",96922,50484,46438
5ea728146307ba36aa1df89b,19171,05000US19171,Tama County,"Tama County, Iowa",17136,8497,8639
5ea728146307ba36aa1df89c,19173,05000US19173,Taylor County,"Taylor County, Iowa",6201,3168,3033
5ea728146307ba36aa1df89d,19175,05000US19175,Union County,"Union County, Iowa",12453,6063,6390
5ea728146307ba36aa1df89e,19177,05000US19177,Van Buren County,"Van Buren County, Iowa",7223,3698,3525
5ea728146307ba36aa1df89f,19179,05000US19179,Wapello County,"Wapello County, Iowa",35315,17403,17912
5ea728146307ba36aa1df8a0,19181,05000US19181,Warren County,"Warren County, Iowa",49361,24118,25243
5ea728146307ba36aa1df8a1,19183,05000US19183,Washington County,"Washington County, Iowa",22143,11075,11068
5ea728146307ba36aa1df8a2,19185,05000US19185,Wayne County,"Wayne County, Iowa",6413,3157,3256
5ea728146307ba36aa1df8a3,19187,05000US19187,Webster County,"Webster County, Iowa",36757,18972,17785
5ea728146307ba36aa1df8a4,19189,05000US19189,Winnebago County,"Winnebago County, Iowa",10571,5190,5381
5ea728146307ba36aa1df8a5,19191,05000US19191,Winneshiek County,"Winneshiek County, Iowa",20401,10156,10245
5ea728146307ba36aa1df8a6,19193,05000US19193,Woodbury County,"Woodbury County, Iowa",102398,50496,51902
5ea728146307ba36aa1df8a7,19195,05000US19195,Worth County,"Worth County, Iowa",7489,3754,3735
5ea728146307ba36aa1df8a8,19197,05000US19197,Wright County,"Wright County, Iowa",12804,6383,6421
5ea728146307ba36aa1df8a9,20001,05000US20001,Allen County,"Allen County, Kansas",12630,6281,6349
5ea728146307ba36aa1df8aa,20003,05000US20003,Anderson County,"Anderson County, Kansas",7852,3932,3920
5ea728146307ba36aa1df8ab,20005,05000US20005,Atchison County,"Atchison County, Kansas",16363,7949,8414
5ea728146307ba36aa1df8ac,20007,05000US20007,Barber County,"Barber County, Kansas",4733,2356,2377
5ea728146307ba36aa1df8ad,20009,05000US20009,Barton County,"Barton County, Kansas",26791,13362,13429
5ea728146307ba36aa1df8ae,20011,05000US20011,Bourbon County,"Bourbon County, Kansas",14702,7243,7459
5ea728146307ba36aa1df8af,20013,05000US20013,Brown County,"Brown County, Kansas",9664,4685,4979
5ea728146307ba36aa1df8b0,20015,05000US20015,Butler County,"Butler County, Kansas",66468,33539,32929
5ea728146307ba36aa1df8b1,20017,05000US20017,Chase County,"Chase County, Kansas",2645,1340,1305
5ea728146307ba36aa1df8b2,20019,05000US20019,Chautauqua County,"Chautauqua County, Kansas",3367,1757,1610
5ea728146307ba36aa1df8b3,20021,05000US20021,Cherokee County,"Cherokee County, Kansas",20331,9998,10333
5ea728146307ba36aa1df8b4,20023,05000US20023,Cheyenne County,"Cheyenne County, Kansas",2677,1320,1357
5ea728146307ba36aa1df8b5,20025,05000US20025,Clark County,"Clark County, Kansas",2053,1037,1016
5ea728146307ba36aa1df8b6,20027,05000US20027,Clay County,"Clay County, Kansas",8142,4078,4064
5ea728146307ba36aa1df8b7,20029,05000US20029,Cloud County,"Cloud County, Kansas",9060,4523,4537
5ea728146307ba36aa1df8b8,20031,05000US20031,Coffey County,"Coffey County, Kansas",8296,4195,4101
5ea728146307ba36aa1df8b9,20033,05000US20033,Comanche County,"Comanche County, Kansas",1780,912,868
5ea728146307ba36aa1df8ba,20035,05000US20035,Cowley County,"Cowley County, Kansas",35591,17915,17676
5ea728146307ba36aa1df8bb,20037,05000US20037,Crawford County,"Crawford County, Kansas",39108,19527,19581
5ea728146307ba36aa1df8bc,20039,05000US20039,Decatur County,"Decatur County, Kansas",2881,1419,1462
5ea728146307ba36aa1df8bd,20041,05000US20041,Dickinson County,"Dickinson County, Kansas",19004,9555,9449
5ea728146307ba36aa1df8be,20043,05000US20043,Doniphan County,"Doniphan County, Kansas",7736,3960,3776
5ea728146307ba36aa1df8bf,20045,05000US20045,Douglas County,"Douglas County, Kansas",119319,59067,60252
5ea728146307ba36aa1df8c0,20047,05000US20047,Edwards County,"Edwards County, Kansas",2925,1494,1431
5ea728146307ba36aa1df8c1,20049,05000US20049,Elk County,"Elk County, Kansas",2562,1258,1304
5ea728146307ba36aa1df8c2,20051,05000US20051,Ellis County,"Ellis County, Kansas",28878,14394,14484
5ea728146307ba36aa1df8c3,20053,05000US20053,Ellsworth County,"Ellsworth County, Kansas",6293,3654,2639
5ea728146307ba36aa1df8c4,20055,05000US20055,Finney County,"Finney County, Kansas",36957,18940,18017
5ea728146307ba36aa1df8c5,20057,05000US20057,Ford County,"Ford County, Kansas",34484,17896,16588
5ea728146307ba36aa1df8c6,20059,05000US20059,Franklin County,"Franklin County, Kansas",25563,12567,12996
5ea728146307ba36aa1df8c7,20061,05000US20061,Geary County,"Geary County, Kansas",34895,18540,16355
5ea728146307ba36aa1df8c8,20063,05000US20063,Gove County,"Gove County, Kansas",2619,1298,1321
5ea728146307ba36aa1df8c9,20065,05000US20065,Graham County,"Graham County, Kansas",2545,1290,1255
5ea728146307ba36aa1df8ca,20067,05000US20067,Grant County,"Grant County, Kansas",7616,3988,3628
5ea728146307ba36aa1df8cb,20069,05000US20069,Gray County,"Gray County, Kansas",6037,3025,3012
5ea728146307ba36aa1df8cc,20071,05000US20071,Greeley County,"Greeley County, Kansas",1200,581,619
5ea728146307ba36aa1df8cd,20073,05000US20073,Greenwood County,"Greenwood County, Kansas",6156,3106,3050
5ea728146307ba36aa1df8ce,20075,05000US20075,Hamilton County,"Hamilton County, Kansas",2616,1353,1263
5ea728146307ba36aa1df8cf,20077,05000US20077,Harper County,"Harper County, Kansas",5673,2884,2789
5ea728146307ba36aa1df8d0,20079,05000US20079,Harvey County,"Harvey County, Kansas",34555,17200,17355
5ea728146307ba36aa1df8d1,20081,05000US20081,Haskell County,"Haskell County, Kansas",4047,2006,2041
5ea728146307ba36aa1df8d2,20083,05000US20083,Hodgeman County,"Hodgeman County, Kansas",1842,941,901
5ea728146307ba36aa1df8d3,20085,05000US20085,Jackson County,"Jackson County, Kansas",13318,6642,6676
5ea728146307ba36aa1df8d4,20087,05000US20087,Jefferson County,"Jefferson County, Kansas",18888,9581,9307
5ea728146307ba36aa1df8d5,20089,05000US20089,Jewell County,"Jewell County, Kansas",2916,1482,1434
5ea728146307ba36aa1df8d6,20091,05000US20091,Johnson County,"Johnson County, Kansas",585502,286987,298515
5ea728146307ba36aa1df8d7,20093,05000US20093,Kearny County,"Kearny County, Kansas",3932,1934,1998
5ea728146307ba36aa1df8d8,20095,05000US20095,Kingman County,"Kingman County, Kansas",7470,3749,3721
5ea728146307ba36aa1df8d9,20097,05000US20097,Kiowa County,"Kiowa County, Kansas",2526,1234,1292
5ea728146307ba36aa1df8da,20099,05000US20099,Labette County,"Labette County, Kansas",20367,10070,10297
5ea728146307ba36aa1df8db,20101,05000US20101,Lane County,"Lane County, Kansas",1642,850,792
5ea728146307ba36aa1df8dc,20103,05000US20103,Leavenworth County,"Leavenworth County, Kansas",80042,42933,37109
5ea728146307ba36aa1df8dd,20105,05000US20105,Lincoln County,"Lincoln County, Kansas",3097,1585,1512
5ea728146307ba36aa1df8de,20107,05000US20107,Linn County,"Linn County, Kansas",9635,4800,4835
5ea728146307ba36aa1df8df,20109,05000US20109,Logan County,"Logan County, Kansas",2810,1398,1412
5ea728146307ba36aa1df8e0,20111,05000US20111,Lyon County,"Lyon County, Kansas",33299,16260,17039
5ea728146307ba36aa1df8e1,20113,05000US20113,McPherson County,"McPherson County, Kansas",28630,14159,14471
5ea728146307ba36aa1df8e2,20115,05000US20115,Marion County,"Marion County, Kansas",12032,5971,6061
5ea728146307ba36aa1df8e3,20117,05000US20117,Marshall County,"Marshall County, Kansas",9798,4924,4874
5ea728146307ba36aa1df8e4,20119,05000US20119,Meade County,"Meade County, Kansas",4261,2129,2132
5ea728146307ba36aa1df8e5,20121,05000US20121,Miami County,"Miami County, Kansas",33127,16384,16743
5ea728146307ba36aa1df8e6,20123,05000US20123,Mitchell County,"Mitchell County, Kansas",6222,3163,3059
5ea728146307ba36aa1df8e7,20125,05000US20125,Montgomery County,"Montgomery County, Kansas",32970,16410,16560
5ea728146307ba36aa1df8e8,20127,05000US20127,Morris County,"Morris County, Kansas",5566,2753,2813
5ea728146307ba36aa1df8e9,20129,05000US20129,Morton County,"Morton County, Kansas",2838,1449,1389
5ea728146307ba36aa1df8ea,20131,05000US20131,Nemaha County,"Nemaha County, Kansas",10104,5119,4985
5ea728146307ba36aa1df8eb,20133,05000US20133,Neosho County,"Neosho County, Kansas",16125,7923,8202
5ea728146307ba36aa1df8ec,20135,05000US20135,Ness County,"Ness County, Kansas",2955,1493,1462
5ea728146307ba36aa1df8ed,20137,05000US20137,Norton County,"Norton County, Kansas",5486,3036,2450
5ea728146307ba36aa1df8ee,20139,05000US20139,Osage County,"Osage County, Kansas",15882,7968,7914
5ea728146307ba36aa1df8ef,20141,05000US20141,Osborne County,"Osborne County, Kansas",3603,1807,1796
5ea728146307ba36aa1df8f0,20143,05000US20143,Ottawa County,"Ottawa County, Kansas",5902,3043,2859
5ea728146307ba36aa1df8f1,20145,05000US20145,Pawnee County,"Pawnee County, Kansas",6709,3769,2940
5ea728146307ba36aa1df8f2,20147,05000US20147,Phillips County,"Phillips County, Kansas",5408,2648,2760
5ea728146307ba36aa1df8f3,20149,05000US20149,Pottawatomie County,"Pottawatomie County, Kansas",23545,11746,11799
5ea728146307ba36aa1df8f4,20151,05000US20151,Pratt County,"Pratt County, Kansas",9582,4785,4797
5ea728146307ba36aa1df8f5,20153,05000US20153,Rawlins County,"Rawlins County, Kansas",2509,1286,1223
5ea728146307ba36aa1df8f6,20155,05000US20155,Reno County,"Reno County, Kansas",63101,31775,31326
5ea728146307ba36aa1df8f7,20157,05000US20157,Republic County,"Republic County, Kansas",4686,2271,2415
5ea728146307ba36aa1df8f8,20159,05000US20159,Rice County,"Rice County, Kansas",9762,4844,4918
5ea728146307ba36aa1df8f9,20161,05000US20161,Riley County,"Riley County, Kansas",75296,39909,35387
5ea728146307ba36aa1df8fa,20163,05000US20163,Rooks County,"Rooks County, Kansas",5118,2469,2649
5ea728146307ba36aa1df8fb,20165,05000US20165,Rush County,"Rush County, Kansas",3102,1521,1581
5ea728146307ba36aa1df8fc,20167,05000US20167,Russell County,"Russell County, Kansas",6977,3452,3525
5ea728146307ba36aa1df8fd,20169,05000US20169,Saline County,"Saline County, Kansas",54977,27375,27602
5ea728146307ba36aa1df8fe,20171,05000US20171,Scott County,"Scott County, Kansas",4949,2460,2489
5ea728146307ba36aa1df8ff,20173,05000US20173,Sedgwick County,"Sedgwick County, Kansas",512064,253201,258863
5ea728146307ba36aa1df900,20175,05000US20175,Seward County,"Seward County, Kansas",22692,11601,11091
5ea728146307ba36aa1df901,20177,05000US20177,Shawnee County,"Shawnee County, Kansas",178284,86327,91957
5ea728146307ba36aa1df902,20179,05000US20179,Sheridan County,"Sheridan County, Kansas",2506,1275,1231
5ea728146307ba36aa1df903,20181,05000US20181,Sherman County,"Sherman County, Kansas",5966,3003,2963
5ea728146307ba36aa1df904,20183,05000US20183,Smith County,"Smith County, Kansas",3663,1809,1854
5ea728146307ba36aa1df905,20185,05000US20185,Stafford County,"Stafford County, Kansas",4214,2157,2057
5ea728146307ba36aa1df906,20187,05000US20187,Stanton County,"Stanton County, Kansas",2063,1055,1008
5ea728146307ba36aa1df907,20189,05000US20189,Stevens County,"Stevens County, Kansas",5686,2882,2804
5ea728146307ba36aa1df908,20191,05000US20191,Sumner County,"Sumner County, Kansas",23208,11581,11627
5ea728146307ba36aa1df909,20193,05000US20193,Thomas County,"Thomas County, Kansas",7824,3816,4008
5ea728146307ba36aa1df90a,20195,05000US20195,Trego County,"Trego County, Kansas",2858,1450,1408
5ea728146307ba36aa1df90b,20197,05000US20197,Wabaunsee County,"Wabaunsee County, Kansas",6888,3497,3391
5ea728146307ba36aa1df90c,20199,05000US20199,Wallace County,"Wallace County, Kansas",1575,790,785
5ea728146307ba36aa1df90d,20201,05000US20201,Washington County,"Washington County, Kansas",5525,2844,2681
5ea728146307ba36aa1df90e,20203,05000US20203,Wichita County,"Wichita County, Kansas",2143,1019,1124
5ea728146307ba36aa1df90f,20205,05000US20205,Wilson County,"Wilson County, Kansas",8780,4318,4462
5ea728146307ba36aa1df910,20207,05000US20207,Woodson County,"Woodson County, Kansas",3170,1583,1587
5ea728146307ba36aa1df911,20209,05000US20209,Wyandotte County,"Wyandotte County, Kansas",164345,81294,83051
5ea728146307ba36aa1df912,21001,05000US21001,Adair County,"Adair County, Kentucky",19241,9525,9716
5ea728146307ba36aa1df913,21003,05000US21003,Allen County,"Allen County, Kentucky",20794,10339,10455
5ea728146307ba36aa1df914,21005,05000US21005,Anderson County,"Anderson County, Kentucky",22214,10873,11341
5ea728146307ba36aa1df915,21007,05000US21007,Ballard County,"Ballard County, Kentucky",8090,3992,4098
5ea728146307ba36aa1df916,21009,05000US21009,Barren County,"Barren County, Kentucky",43680,21165,22515
5ea728146307ba36aa1df917,21011,05000US21011,Bath County,"Bath County, Kentucky",12268,6096,6172
5ea728146307ba36aa1df918,21013,05000US21013,Bell County,"Bell County, Kentucky",27188,13325,13863
5ea728146307ba36aa1df919,21015,05000US21015,Boone County,"Boone County, Kentucky",129095,64061,65034
5ea728146307ba36aa1df91a,21017,05000US21017,Bourbon County,"Bourbon County, Kentucky",20144,9670,10474
5ea728146307ba36aa1df91b,21019,05000US21019,Boyd County,"Boyd County, Kentucky",48091,23958,24133
5ea728146307ba36aa1df91c,21021,05000US21021,Boyle County,"Boyle County, Kentucky",29913,14903,15010
5ea728146307ba36aa1df91d,21023,05000US21023,Bracken County,"Bracken County, Kentucky",8306,4183,4123
5ea728146307ba36aa1df91e,21025,05000US21025,Breathitt County,"Breathitt County, Kentucky",13116,6577,6539
5ea728146307ba36aa1df91f,21027,05000US21027,Breckinridge County,"Breckinridge County, Kentucky",20080,10088,9992
5ea728146307ba36aa1df920,21029,05000US21029,Bullitt County,"Bullitt County, Kentucky",79466,39627,39839
5ea728146307ba36aa1df921,21031,05000US21031,Butler County,"Butler County, Kentucky",12745,6412,6333
5ea728146307ba36aa1df922,21033,05000US21033,Caldwell County,"Caldwell County, Kentucky",12727,6168,6559
5ea728146307ba36aa1df923,21035,05000US21035,Calloway County,"Calloway County, Kentucky",38776,18818,19958
5ea728146307ba36aa1df924,21037,05000US21037,Campbell County,"Campbell County, Kentucky",92267,45124,47143
5ea728146307ba36aa1df925,21039,05000US21039,Carlisle County,"Carlisle County, Kentucky",4841,2344,2497
5ea728146307ba36aa1df926,21041,05000US21041,Carroll County,"Carroll County, Kentucky",10711,5455,5256
5ea728146307ba36aa1df927,21043,05000US21043,Carter County,"Carter County, Kentucky",27290,13437,13853
5ea728146307ba36aa1df928,21045,05000US21045,Casey County,"Casey County, Kentucky",15796,7738,8058
5ea728146307ba36aa1df929,21047,05000US21047,Christian County,"Christian County, Kentucky",72263,38411,33852
5ea728146307ba36aa1df92a,21049,05000US21049,Clark County,"Clark County, Kentucky",35872,17573,18299
5ea728146307ba36aa1df92b,21051,05000US21051,Clay County,"Clay County, Kentucky",20621,10827,9794
5ea728146307ba36aa1df92c,21053,05000US21053,Clinton County,"Clinton County, Kentucky",10211,5084,5127
5ea728146307ba36aa1df92d,21055,05000US21055,Crittenden County,"Crittenden County, Kentucky",9083,4593,4490
5ea728146307ba36aa1df92e,21057,05000US21057,Cumberland County,"Cumberland County, Kentucky",6713,3289,3424
5ea728146307ba36aa1df92f,21059,05000US21059,Daviess County,"Daviess County, Kentucky",99937,48742,51195
5ea728146307ba36aa1df930,21061,05000US21061,Edmonson County,"Edmonson County, Kentucky",12122,6093,6029
5ea728146307ba36aa1df931,21063,05000US21063,Elliott County,"Elliott County, Kentucky",7517,4285,3232
5ea728146307ba36aa1df932,21065,05000US21065,Estill County,"Estill County, Kentucky",14313,7104,7209
5ea728146307ba36aa1df933,21067,05000US21067,Fayette County,"Fayette County, Kentucky",318734,156453,162281
5ea728146307ba36aa1df934,21069,05000US21069,Fleming County,"Fleming County, Kentucky",14479,7146,7333
5ea728146307ba36aa1df935,21071,05000US21071,Floyd County,"Floyd County, Kentucky",36926,18070,18856
5ea728146307ba36aa1df936,21073,05000US21073,Franklin County,"Franklin County, Kentucky",50296,24390,25906
5ea728146307ba36aa1df937,21075,05000US21075,Fulton County,"Fulton County, Kentucky",6210,3102,3108
5ea728146307ba36aa1df938,21077,05000US21077,Gallatin County,"Gallatin County, Kentucky",8703,4473,4230
5ea728146307ba36aa1df939,21079,05000US21079,Garrard County,"Garrard County, Kentucky",17328,8475,8853
5ea728146307ba36aa1df93a,21081,05000US21081,Grant County,"Grant County, Kentucky",24915,12318,12597
5ea728146307ba36aa1df93b,21083,05000US21083,Graves County,"Graves County, Kentucky",37294,18348,18946
5ea728146307ba36aa1df93c,21085,05000US21085,Grayson County,"Grayson County, Kentucky",26178,13073,13105
5ea728146307ba36aa1df93d,21087,05000US21087,Green County,"Green County, Kentucky",11023,5393,5630
5ea728146307ba36aa1df93e,21089,05000US21089,Greenup County,"Greenup County, Kentucky",35765,17411,18354
5ea728146307ba36aa1df93f,21091,05000US21091,Hancock County,"Hancock County, Kentucky",8719,4494,4225
5ea728146307ba36aa1df940,21093,05000US21093,Hardin County,"Hardin County, Kentucky",108095,53723,54372
5ea728146307ba36aa1df941,21095,05000US21095,Harlan County,"Harlan County, Kentucky",27134,13132,14002
5ea728146307ba36aa1df942,21097,05000US21097,Harrison County,"Harrison County, Kentucky",18668,9146,9522
5ea728146307ba36aa1df943,21099,05000US21099,Hart County,"Hart County, Kentucky",18627,9166,9461
5ea728146307ba36aa1df944,21101,05000US21101,Henderson County,"Henderson County, Kentucky",46137,22328,23809
5ea728146307ba36aa1df945,21103,05000US21103,Henry County,"Henry County, Kentucky",15814,7813,8001
5ea728146307ba36aa1df946,21105,05000US21105,Hickman County,"Hickman County, Kentucky",4568,2133,2435
5ea728146307ba36aa1df947,21107,05000US21107,Hopkins County,"Hopkins County, Kentucky",45664,22219,23445
5ea728146307ba36aa1df948,21109,05000US21109,Jackson County,"Jackson County, Kentucky",13373,6655,6718
5ea728146307ba36aa1df949,21111,05000US21111,Jefferson County,"Jefferson County, Kentucky",767154,370844,396310
5ea728146307ba36aa1df94a,21113,05000US21113,Jessamine County,"Jessamine County, Kentucky",52422,25479,26943
5ea728146307ba36aa1df94b,21115,05000US21115,Johnson County,"Johnson County, Kentucky",22843,11200,11643
5ea728146307ba36aa1df94c,21117,05000US21117,Kenton County,"Kenton County, Kentucky",164688,81430,83258
5ea728146307ba36aa1df94d,21119,05000US21119,Knott County,"Knott County, Kentucky",15513,7693,7820
5ea728146307ba36aa1df94e,21121,05000US21121,Knox County,"Knox County, Kentucky",31467,15330,16137
5ea728146307ba36aa1df94f,21123,05000US21123,Larue County,"Larue County, Kentucky",14156,7027,7129
5ea728146307ba36aa1df950,21125,05000US21125,Laurel County,"Laurel County, Kentucky",60180,29412,30768
5ea728146307ba36aa1df951,21127,05000US21127,Lawrence County,"Lawrence County, Kentucky",15783,7898,7885
5ea728146307ba36aa1df952,21129,05000US21129,Lee County,"Lee County, Kentucky",6751,3501,3250
5ea728146307ba36aa1df953,21131,05000US21131,Leslie County,"Leslie County, Kentucky",10472,5067,5405
5ea728146307ba36aa1df954,21133,05000US21133,Letcher County,"Letcher County, Kentucky",22676,11087,11589
5ea728146307ba36aa1df955,21135,05000US21135,Lewis County,"Lewis County, Kentucky",13490,6714,6776
5ea728146307ba36aa1df956,21137,05000US21137,Lincoln County,"Lincoln County, Kentucky",24458,11981,12477
5ea728146307ba36aa1df957,21139,05000US21139,Livingston County,"Livingston County, Kentucky",9263,4626,4637
5ea728146307ba36aa1df958,21141,05000US21141,Logan County,"Logan County, Kentucky",26849,13154,13695
5ea728146307ba36aa1df959,21143,05000US21143,Lyon County,"Lyon County, Kentucky",8186,4496,3690
5ea728146307ba36aa1df95a,21145,05000US21145,McCracken County,"McCracken County, Kentucky",65284,31193,34091
5ea728146307ba36aa1df95b,21147,05000US21147,McCreary County,"McCreary County, Kentucky",17635,9613,8022
5ea728146307ba36aa1df95c,21149,05000US21149,McLean County,"McLean County, Kentucky",9331,4602,4729
5ea728146307ba36aa1df95d,21151,05000US21151,Madison County,"Madison County, Kentucky",89700,43737,45963
5ea728146307ba36aa1df95e,21153,05000US21153,Magoffin County,"Magoffin County, Kentucky",12666,6348,6318
5ea728146307ba36aa1df95f,21155,05000US21155,Marion County,"Marion County, Kentucky",19232,9751,9481
5ea728146307ba36aa1df960,21157,05000US21157,Marshall County,"Marshall County, Kentucky",31166,15341,15825
5ea728146307ba36aa1df961,21159,05000US21159,Martin County,"Martin County, Kentucky",11919,6583,5336
5ea728146307ba36aa1df962,21161,05000US21161,Mason County,"Mason County, Kentucky",17153,8485,8668
5ea728146307ba36aa1df963,21163,05000US21163,Meade County,"Meade County, Kentucky",28326,14352,13974
5ea728146307ba36aa1df964,21165,05000US21165,Menifee County,"Menifee County, Kentucky",6405,3421,2984
5ea728146307ba36aa1df965,21167,05000US21167,Mercer County,"Mercer County, Kentucky",21516,10597,10919
5ea728146307ba36aa1df966,21169,05000US21169,Metcalfe County,"Metcalfe County, Kentucky",10004,4923,5081
5ea728146307ba36aa1df967,21171,05000US21171,Monroe County,"Monroe County, Kentucky",10634,5370,5264
5ea728146307ba36aa1df968,21173,05000US21173,Montgomery County,"Montgomery County, Kentucky",27759,13541,14218
5ea728146307ba36aa1df969,21175,05000US21175,Morgan County,"Morgan County, Kentucky",13285,7425,5860
5ea728146307ba36aa1df96a,21177,05000US21177,Muhlenberg County,"Muhlenberg County, Kentucky",31081,15286,15795
5ea728146307ba36aa1df96b,21179,05000US21179,Nelson County,"Nelson County, Kentucky",45388,22492,22896
5ea728146307ba36aa1df96c,21181,05000US21181,Nicholas County,"Nicholas County, Kentucky",7100,3369,3731
5ea728146307ba36aa1df96d,21183,05000US21183,Ohio County,"Ohio County, Kentucky",24071,11960,12111
5ea728146307ba36aa1df96e,21185,05000US21185,Oldham County,"Oldham County, Kentucky",65374,34328,31046
5ea728146307ba36aa1df96f,21187,05000US21187,Owen County,"Owen County, Kentucky",10741,5304,5437
5ea728146307ba36aa1df970,21189,05000US21189,Owsley County,"Owsley County, Kentucky",4463,1947,2516
5ea728146307ba36aa1df971,21191,05000US21191,Pendleton County,"Pendleton County, Kentucky",14520,7360,7160
5ea728146307ba36aa1df972,21193,05000US21193,Perry County,"Perry County, Kentucky",26917,13273,13644
5ea728146307ba36aa1df973,21195,05000US21195,Pike County,"Pike County, Kentucky",60483,29507,30976
5ea728146307ba36aa1df974,21197,05000US21197,Powell County,"Powell County, Kentucky",12321,6048,6273
5ea728146307ba36aa1df975,21199,05000US21199,Pulaski County,"Pulaski County, Kentucky",64145,31517,32628
5ea728146307ba36aa1df976,21201,05000US21201,Robertson County,"Robertson County, Kentucky",2143,1147,996
5ea728146307ba36aa1df977,21203,05000US21203,Rockcastle County,"Rockcastle County, Kentucky",16827,8170,8657
5ea728146307ba36aa1df978,21205,05000US21205,Rowan County,"Rowan County, Kentucky",24499,11763,12736
5ea728146307ba36aa1df979,21207,05000US21207,Russell County,"Russell County, Kentucky",17760,8688,9072
5ea728146307ba36aa1df97a,21209,05000US21209,Scott County,"Scott County, Kentucky",53517,26516,27001
5ea728146307ba36aa1df97b,21211,05000US21211,Shelby County,"Shelby County, Kentucky",46786,22613,24173
5ea728146307ba36aa1df97c,21213,05000US21213,Simpson County,"Simpson County, Kentucky",18063,8926,9137
5ea728146307ba36aa1df97d,21215,05000US21215,Spencer County,"Spencer County, Kentucky",18246,9277,8969
5ea728146307ba36aa1df97e,21217,05000US21217,Taylor County,"Taylor County, Kentucky",25500,12525,12975
5ea728146307ba36aa1df97f,21219,05000US21219,Todd County,"Todd County, Kentucky",12350,6049,6301
5ea728146307ba36aa1df980,21221,05000US21221,Trigg County,"Trigg County, Kentucky",14344,7077,7267
5ea728146307ba36aa1df981,21223,05000US21223,Trimble County,"Trimble County, Kentucky",8637,4238,4399
5ea728146307ba36aa1df982,21225,05000US21225,Union County,"Union County, Kentucky",14802,7597,7205
5ea728146307ba36aa1df983,21227,05000US21227,Warren County,"Warren County, Kentucky",126427,61873,64554
5ea728146307ba36aa1df984,21229,05000US21229,Washington County,"Washington County, Kentucky",12019,5865,6154
5ea728146307ba36aa1df985,21231,05000US21231,Wayne County,"Wayne County, Kentucky",20609,10154,10455
5ea728146307ba36aa1df986,21233,05000US21233,Webster County,"Webster County, Kentucky",13155,6457,6698
5ea728146307ba36aa1df987,21235,05000US21235,Whitley County,"Whitley County, Kentucky",36089,17668,18421
5ea728146307ba36aa1df988,21237,05000US21237,Wolfe County,"Wolfe County, Kentucky",7223,3596,3627
5ea728146307ba36aa1df989,21239,05000US21239,Woodford County,"Woodford County, Kentucky",26097,12564,13533
5ea728146307ba36aa1df98a,22001,05000US22001,Acadia Parish,"Acadia Parish, Louisiana",62568,30491,32077
5ea728146307ba36aa1df98b,22003,05000US22003,Allen Parish,"Allen Parish, Louisiana",25661,14638,11023
5ea728146307ba36aa1df98c,22005,05000US22005,Ascension Parish,"Ascension Parish, Louisiana",121176,59998,61178
5ea728146307ba36aa1df98d,22007,05000US22007,Assumption Parish,"Assumption Parish, Louisiana",22714,11005,11709
5ea728146307ba36aa1df98e,22009,05000US22009,Avoyelles Parish,"Avoyelles Parish, Louisiana",40882,20607,20275
5ea728146307ba36aa1df98f,22011,05000US22011,Beauregard Parish,"Beauregard Parish, Louisiana",36769,18712,18057
5ea728146307ba36aa1df990,22013,05000US22013,Bienville Parish,"Bienville Parish, Louisiana",13668,6523,7145
5ea728146307ba36aa1df991,22015,05000US22015,Bossier Parish,"Bossier Parish, Louisiana",126131,62349,63782
5ea728146307ba36aa1df992,22017,05000US22017,Caddo Parish,"Caddo Parish, Louisiana",248361,117828,130533
5ea728146307ba36aa1df993,22019,05000US22019,Calcasieu Parish,"Calcasieu Parish, Louisiana",200182,97603,102579
5ea728146307ba36aa1df994,22021,05000US22021,Caldwell Parish,"Caldwell Parish, Louisiana",9996,5277,4719
5ea728146307ba36aa1df995,22023,05000US22023,Cameron Parish,"Cameron Parish, Louisiana",6868,3357,3511
5ea728146307ba36aa1df996,22025,05000US22025,Catahoula Parish,"Catahoula Parish, Louisiana",9893,5214,4679
5ea728146307ba36aa1df997,22027,05000US22027,Claiborne Parish,"Claiborne Parish, Louisiana",16153,9205,6948
5ea728146307ba36aa1df998,22029,05000US22029,Concordia Parish,"Concordia Parish, Louisiana",20021,10210,9811
5ea728146307ba36aa1df999,22031,05000US22031,De Soto Parish,"De Soto Parish, Louisiana",27216,13172,14044
5ea728146307ba36aa1df99a,22033,05000US22033,East Baton Rouge Parish,"East Baton Rouge Parish, Louisiana",444094,212778,231316
5ea728146307ba36aa1df99b,22035,05000US22035,East Carroll Parish,"East Carroll Parish, Louisiana",7225,4373,2852
5ea728146307ba36aa1df99c,22037,05000US22037,East Feliciana Parish,"East Feliciana Parish, Louisiana",19499,10715,8784
5ea728146307ba36aa1df99d,22039,05000US22039,Evangeline Parish,"Evangeline Parish, Louisiana",33636,17142,16494
5ea728146307ba36aa1df99e,22041,05000US22041,Franklin Parish,"Franklin Parish, Louisiana",20322,9981,10341
5ea728146307ba36aa1df99f,22043,05000US22043,Grant Parish,"Grant Parish, Louisiana",22348,12658,9690
5ea728146307ba36aa1df9a0,22045,05000US22045,Iberia Parish,"Iberia Parish, Louisiana",72691,35508,37183
5ea728146307ba36aa1df9a1,22047,05000US22047,Iberville Parish,"Iberville Parish, Louisiana",32956,16661,16295
5ea728146307ba36aa1df9a2,22049,05000US22049,Jackson Parish,"Jackson Parish, Louisiana",15926,8080,7846
5ea728146307ba36aa1df9a3,22051,05000US22051,Jefferson Parish,"Jefferson Parish, Louisiana",435300,211175,224125
5ea728146307ba36aa1df9a4,22053,05000US22053,Jefferson Davis Parish,"Jefferson Davis Parish, Louisiana",31467,15590,15877
5ea728146307ba36aa1df9a5,22055,05000US22055,Lafayette Parish,"Lafayette Parish, Louisiana",240091,117169,122922
5ea728146307ba36aa1df9a6,22057,05000US22057,Lafourche Parish,"Lafourche Parish, Louisiana",98214,48261,49953
5ea728146307ba36aa1df9a7,22059,05000US22059,LaSalle Parish,"LaSalle Parish, Louisiana",14949,7730,7219
5ea728146307ba36aa1df9a8,22061,05000US22061,Lincoln Parish,"Lincoln Parish, Louisiana",47356,23041,24315
5ea728146307ba36aa1df9a9,22063,05000US22063,Livingston Parish,"Livingston Parish, Louisiana",138111,67836,70275
5ea728146307ba36aa1df9aa,22065,05000US22065,Madison Parish,"Madison Parish, Louisiana",11472,5708,5764
5ea728146307ba36aa1df9ab,22067,05000US22067,Morehouse Parish,"Morehouse Parish, Louisiana",25992,12444,13548
5ea728146307ba36aa1df9ac,22069,05000US22069,Natchitoches Parish,"Natchitoches Parish, Louisiana",38963,18622,20341
5ea728146307ba36aa1df9ad,22071,05000US22071,Orleans Parish,"Orleans Parish, Louisiana",389648,185377,204271
5ea728146307ba36aa1df9ae,22073,05000US22073,Ouachita Parish,"Ouachita Parish, Louisiana",156075,74853,81222
5ea728146307ba36aa1df9af,22075,05000US22075,Plaquemines Parish,"Plaquemines Parish, Louisiana",23373,11617,11756
5ea728146307ba36aa1df9b0,22077,05000US22077,Pointe Coupee Parish,"Pointe Coupee Parish, Louisiana",22158,10614,11544
5ea728146307ba36aa1df9b1,22079,05000US22079,Rapides Parish,"Rapides Parish, Louisiana",131546,63681,67865
5ea728146307ba36aa1df9b2,22081,05000US22081,Red River Parish,"Red River Parish, Louisiana",8618,4067,4551
5ea728146307ba36aa1df9b3,22083,05000US22083,Richland Parish,"Richland Parish, Louisiana",20474,9952,10522
5ea728146307ba36aa1df9b4,22085,05000US22085,Sabine Parish,"Sabine Parish, Louisiana",24088,11929,12159
5ea728146307ba36aa1df9b5,22087,05000US22087,St. Bernard Parish,"St. Bernard Parish, Louisiana",45694,22402,23292
5ea728146307ba36aa1df9b6,22089,05000US22089,St. Charles Parish,"St. Charles Parish, Louisiana",52724,26121,26603
5ea728146307ba36aa1df9b7,22091,05000US22091,St. Helena Parish,"St. Helena Parish, Louisiana",10411,5039,5372
5ea728146307ba36aa1df9b8,22093,05000US22093,St. James Parish,"St. James Parish, Louisiana",21357,10266,11091
5ea728146307ba36aa1df9b9,22095,05000US22095,St. John the Baptist Parish,"St. John the Baptist Parish, Louisiana",43446,21308,22138
5ea728146307ba36aa1df9ba,22097,05000US22097,St. Landry Parish,"St. Landry Parish, Louisiana",83449,40151,43298
5ea728146307ba36aa1df9bb,22099,05000US22099,St. Martin Parish,"St. Martin Parish, Louisiana",53752,26452,27300
5ea728146307ba36aa1df9bc,22101,05000US22101,St. Mary Parish,"St. Mary Parish, Louisiana",51734,25607,26127
5ea728146307ba36aa1df9bd,22103,05000US22103,St. Tammany Parish,"St. Tammany Parish, Louisiana",252093,122347,129746
5ea728146307ba36aa1df9be,22105,05000US22105,Tangipahoa Parish,"Tangipahoa Parish, Louisiana",130504,63237,67267
5ea728146307ba36aa1df9bf,22107,05000US22107,Tensas Parish,"Tensas Parish, Louisiana",4666,2296,2370
5ea728146307ba36aa1df9c0,22109,05000US22109,Terrebonne Parish,"Terrebonne Parish, Louisiana",112587,55305,57282
5ea728146307ba36aa1df9c1,22111,05000US22111,Union Parish,"Union Parish, Louisiana",22475,11132,11343
5ea728146307ba36aa1df9c2,22113,05000US22113,Vermilion Parish,"Vermilion Parish, Louisiana",59867,29121,30746
5ea728146307ba36aa1df9c3,22115,05000US22115,Vernon Parish,"Vernon Parish, Louisiana",51007,27126,23881
5ea728146307ba36aa1df9c4,22117,05000US22117,Washington Parish,"Washington Parish, Louisiana",46457,22963,23494
5ea728146307ba36aa1df9c5,22119,05000US22119,Webster Parish,"Webster Parish, Louisiana",39631,19242,20389
5ea728146307ba36aa1df9c6,22121,05000US22121,West Baton Rouge Parish,"West Baton Rouge Parish, Louisiana",25860,12863,12997
5ea728146307ba36aa1df9c7,22123,05000US22123,West Carroll Parish,"West Carroll Parish, Louisiana",11180,5704,5476
5ea728146307ba36aa1df9c8,22125,05000US22125,West Feliciana Parish,"West Feliciana Parish, Louisiana",15377,9802,5575
5ea728146307ba36aa1df9c9,22127,05000US22127,Winn Parish,"Winn Parish, Louisiana",14494,7733,6761
5ea728146307ba36aa1df9ca,23001,05000US23001,Androscoggin County,"Androscoggin County, Maine",107444,52514,54930
5ea728146307ba36aa1df9cb,23003,05000US23003,Aroostook County,"Aroostook County, Maine",68269,33745,34524
5ea728146307ba36aa1df9cc,23005,05000US23005,Cumberland County,"Cumberland County, Maine",290944,141276,149668
5ea728146307ba36aa1df9cd,23007,05000US23007,Franklin County,"Franklin County, Maine",30019,14651,15368
5ea728146307ba36aa1df9ce,23009,05000US23009,Hancock County,"Hancock County, Maine",54541,26374,28167
5ea728146307ba36aa1df9cf,23011,05000US23011,Kennebec County,"Kennebec County, Maine",121545,59159,62386
5ea728146307ba36aa1df9d0,23013,05000US23013,Knox County,"Knox County, Maine",39823,19701,20122
5ea728146307ba36aa1df9d1,23015,05000US23015,Lincoln County,"Lincoln County, Maine",34067,16624,17443
5ea728146307ba36aa1df9d2,23017,05000US23017,Oxford County,"Oxford County, Maine",57325,28316,29009
5ea728146307ba36aa1df9d3,23019,05000US23019,Penobscot County,"Penobscot County, Maine",151748,75196,76552
5ea728146307ba36aa1df9d4,23021,05000US23021,Piscataquis County,"Piscataquis County, Maine",16887,8440,8447
5ea728146307ba36aa1df9d5,23023,05000US23023,Sagadahoc County,"Sagadahoc County, Maine",35277,17228,18049
5ea728146307ba36aa1df9d6,23025,05000US23025,Somerset County,"Somerset County, Maine",50710,25085,25625
5ea728146307ba36aa1df9d7,23027,05000US23027,Waldo County,"Waldo County, Maine",39418,19347,20071
5ea728146307ba36aa1df9d8,23029,05000US23029,Washington County,"Washington County, Maine",31694,15614,16080
5ea728146307ba36aa1df9d9,23031,05000US23031,York County,"York County, Maine",203102,99029,104073
5ea728146307ba36aa1df9da,24001,05000US24001,Allegany County,"Allegany County, Maryland",71977,37646,34331
5ea728146307ba36aa1df9db,24003,05000US24003,Anne Arundel County,"Anne Arundel County, Maryland",567696,281176,286520
5ea728146307ba36aa1df9dc,24005,05000US24005,Baltimore County,"Baltimore County, Maryland",827625,392421,435204
5ea728146307ba36aa1df9dd,24009,05000US24009,Calvert County,"Calvert County, Maryland",91082,45307,45775
5ea728146307ba36aa1df9de,24011,05000US24011,Caroline County,"Caroline County, Maryland",32875,16021,16854
5ea728146307ba36aa1df9df,24013,05000US24013,Carroll County,"Carroll County, Maryland",167522,82841,84681
5ea728146307ba36aa1df9e0,24015,05000US24015,Cecil County,"Cecil County, Maryland",102517,51149,51368
5ea728146307ba36aa1df9e1,24017,05000US24017,Charles County,"Charles County, Maryland",157671,76071,81600
5ea728146307ba36aa1df9e2,24019,05000US24019,Dorchester County,"Dorchester County, Maryland",32261,15335,16926
5ea728146307ba36aa1df9e3,24021,05000US24021,Frederick County,"Frederick County, Maryland",248472,122524,125948
5ea728146307ba36aa1df9e4,24023,05000US24023,Garrett County,"Garrett County, Maryland",29376,14561,14815
5ea728146307ba36aa1df9e5,24025,05000US24025,Harford County,"Harford County, Maryland",251025,122763,128262
5ea728146307ba36aa1df9e6,24027,05000US24027,Howard County,"Howard County, Maryland",315327,154285,161042
5ea728146307ba36aa1df9e7,24029,05000US24029,Kent County,"Kent County, Maryland",19593,9344,10249
5ea728146307ba36aa1df9e8,24031,05000US24031,Montgomery County,"Montgomery County, Maryland",1040133,502389,537744
5ea728146307ba36aa1df9e9,24033,05000US24033,Prince George's County,"Prince George's County, Maryland",906202,436446,469756
5ea728146307ba36aa1df9ea,24035,05000US24035,Queen Anne's County,"Queen Anne's County, Maryland",49355,24426,24929
5ea728146307ba36aa1df9eb,24037,05000US24037,St. Mary's County,"St. Mary's County, Maryland",111531,55552,55979
5ea728146307ba36aa1df9ec,24039,05000US24039,Somerset County,"Somerset County, Maryland",25737,13833,11904
5ea728146307ba36aa1df9ed,24041,05000US24041,Talbot County,"Talbot County, Maryland",37211,17626,19585
5ea728146307ba36aa1df9ee,24043,05000US24043,Washington County,"Washington County, Maryland",149811,76098,73713
5ea728146307ba36aa1df9ef,24045,05000US24045,Wicomico County,"Wicomico County, Maryland",102172,48535,53637
5ea728146307ba36aa1df9f0,24047,05000US24047,Worcester County,"Worcester County, Maryland",51564,25283,26281
5ea728146307ba36aa1df9f1,24510,05000US24510,Baltimore city,"Baltimore city, Maryland",614700,288691,326009
5ea728146307ba36aa1df9f2,25001,05000US25001,Barnstable County,"Barnstable County, Massachusetts",213690,102176,111514
5ea728146307ba36aa1df9f3,25003,05000US25003,Berkshire County,"Berkshire County, Massachusetts",127328,61603,65725
5ea728146307ba36aa1df9f4,25005,05000US25005,Bristol County,"Bristol County, Massachusetts",558905,270624,288281
5ea728146307ba36aa1df9f5,25007,05000US25007,Dukes County,"Dukes County, Massachusetts",17313,8475,8838
5ea728146307ba36aa1df9f6,25009,05000US25009,Essex County,"Essex County, Massachusetts",781024,376475,404549
5ea728146307ba36aa1df9f7,25011,05000US25011,Franklin County,"Franklin County, Massachusetts",70935,34601,36334
5ea728146307ba36aa1df9f8,25013,05000US25013,Hampden County,"Hampden County, Massachusetts",469116,226555,242561
5ea728146307ba36aa1df9f9,25015,05000US25015,Hampshire County,"Hampshire County, Massachusetts",161159,75426,85733
5ea728146307ba36aa1df9fa,25017,05000US25017,Middlesex County,"Middlesex County, Massachusetts",1595192,779666,815526
5ea728146307ba36aa1df9fb,25019,05000US25019,Nantucket County,"Nantucket County, Massachusetts",11101,5650,5451
5ea728146307ba36aa1df9fc,25021,05000US25021,Norfolk County,"Norfolk County, Massachusetts",698249,335338,362911
5ea728146307ba36aa1df9fd,25023,05000US25023,Plymouth County,"Plymouth County, Massachusetts",512135,249126,263009
5ea728146307ba36aa1df9fe,25025,05000US25025,Suffolk County,"Suffolk County, Massachusetts",791766,382830,408936
5ea728146307ba36aa1df9ff,25027,05000US25027,Worcester County,"Worcester County, Massachusetts",822280,405434,416846
5ea728146307ba36aa1dfa00,26001,05000US26001,Alcona County,"Alcona County, Michigan",10364,5224,5140
5ea728146307ba36aa1dfa01,26003,05000US26003,Alger County,"Alger County, Michigan",9194,5104,4090
5ea728146307ba36aa1dfa02,26005,05000US26005,Allegan County,"Allegan County, Michigan",115250,57586,57664
5ea728146307ba36aa1dfa03,26007,05000US26007,Alpena County,"Alpena County, Michigan",28612,14095,14517
5ea728146307ba36aa1dfa04,26009,05000US26009,Antrim County,"Antrim County, Michigan",23177,11515,11662
5ea728146307ba36aa1dfa05,26011,05000US26011,Arenac County,"Arenac County, Michigan",15165,7681,7484
5ea728146307ba36aa1dfa06,26013,05000US26013,Baraga County,"Baraga County, Michigan",8507,4720,3787
5ea728146307ba36aa1dfa07,26015,05000US26015,Barry County,"Barry County, Michigan",60057,30248,29809
5ea728146307ba36aa1dfa08,26017,05000US26017,Bay County,"Bay County, Michigan",104786,51486,53300
5ea728146307ba36aa1dfa09,26019,05000US26019,Benzie County,"Benzie County, Michigan",17552,8743,8809
5ea728146307ba36aa1dfa0a,26021,05000US26021,Berrien County,"Berrien County, Michigan",154807,75737,79070
5ea728146307ba36aa1dfa0b,26023,05000US26023,Branch County,"Branch County, Michigan",43584,22485,21099
5ea728146307ba36aa1dfa0c,26025,05000US26025,Calhoun County,"Calhoun County, Michigan",134473,65782,68691
5ea728146307ba36aa1dfa0d,26027,05000US26027,Cass County,"Cass County, Michigan",51460,25789,25671
5ea728146307ba36aa1dfa0e,26029,05000US26029,Charlevoix County,"Charlevoix County, Michigan",26219,12907,13312
5ea728146307ba36aa1dfa0f,26031,05000US26031,Cheboygan County,"Cheboygan County, Michigan",25458,12720,12738
5ea728146307ba36aa1dfa10,26033,05000US26033,Chippewa County,"Chippewa County, Michigan",37834,20794,17040
5ea728146307ba36aa1dfa11,26035,05000US26035,Clare County,"Clare County, Michigan",30616,15159,15457
5ea728146307ba36aa1dfa12,26037,05000US26037,Clinton County,"Clinton County, Michigan",77896,38528,39368
5ea728146307ba36aa1dfa13,26039,05000US26039,Crawford County,"Crawford County, Michigan",13836,7060,6776
5ea728146307ba36aa1dfa14,26041,05000US26041,Delta County,"Delta County, Michigan",36190,17998,18192
5ea728146307ba36aa1dfa15,26043,05000US26043,Dickinson County,"Dickinson County, Michigan",25570,12754,12816
5ea728146307ba36aa1dfa16,26045,05000US26045,Eaton County,"Eaton County, Michigan",109155,53353,55802
5ea728146307ba36aa1dfa17,26047,05000US26047,Emmet County,"Emmet County, Michigan",33039,16307,16732
5ea728146307ba36aa1dfa18,26049,05000US26049,Genesee County,"Genesee County, Michigan",409361,197382,211979
5ea728146307ba36aa1dfa19,26051,05000US26051,Gladwin County,"Gladwin County, Michigan",25289,12739,12550
5ea728146307ba36aa1dfa1a,26053,05000US26053,Gogebic County,"Gogebic County, Michigan",15414,8324,7090
5ea728146307ba36aa1dfa1b,26055,05000US26055,Grand Traverse County,"Grand Traverse County, Michigan",91746,45367,46379
5ea728146307ba36aa1dfa1c,26057,05000US26057,Gratiot County,"Gratiot County, Michigan",41067,21961,19106
5ea728146307ba36aa1dfa1d,26059,05000US26059,Hillsdale County,"Hillsdale County, Michigan",45830,22798,23032
5ea728146307ba36aa1dfa1e,26061,05000US26061,Houghton County,"Houghton County, Michigan",36360,19668,16692
5ea728146307ba36aa1dfa1f,26063,05000US26063,Huron County,"Huron County, Michigan",31543,15692,15851
5ea728146307ba36aa1dfa20,26065,05000US26065,Ingham County,"Ingham County, Michigan",289564,140970,148594
5ea728146307ba36aa1dfa21,26067,05000US26067,Ionia County,"Ionia County, Michigan",64176,34053,30123
5ea728146307ba36aa1dfa22,26069,05000US26069,Iosco County,"Iosco County, Michigan",25247,12578,12669
5ea728146307ba36aa1dfa23,26071,05000US26071,Iron County,"Iron County, Michigan",11212,5595,5617
5ea728146307ba36aa1dfa24,26073,05000US26073,Isabella County,"Isabella County, Michigan",70775,34371,36404
5ea728146307ba36aa1dfa25,26075,05000US26075,Jackson County,"Jackson County, Michigan",158913,81205,77708
5ea728146307ba36aa1dfa26,26077,05000US26077,Kalamazoo County,"Kalamazoo County, Michigan",261573,128025,133548
5ea728146307ba36aa1dfa27,26079,05000US26079,Kalkaska County,"Kalkaska County, Michigan",17463,8908,8555
5ea728146307ba36aa1dfa28,26081,05000US26081,Kent County,"Kent County, Michigan",643140,316734,326406
5ea728146307ba36aa1dfa29,26083,05000US26083,Keweenaw County,"Keweenaw County, Michigan",2130,1111,1019
5ea728146307ba36aa1dfa2a,26085,05000US26085,Lake County,"Lake County, Michigan",11763,6000,5763
5ea728146307ba36aa1dfa2b,26087,05000US26087,Lapeer County,"Lapeer County, Michigan",88202,44842,43360
5ea728146307ba36aa1dfa2c,26089,05000US26089,Leelanau County,"Leelanau County, Michigan",21639,10742,10897
5ea728146307ba36aa1dfa2d,26091,05000US26091,Lenawee County,"Lenawee County, Michigan",98474,49815,48659
5ea728146307ba36aa1dfa2e,26093,05000US26093,Livingston County,"Livingston County, Michigan",188482,94566,93916
5ea728146307ba36aa1dfa2f,26095,05000US26095,Luce County,"Luce County, Michigan",6364,3743,2621
5ea728146307ba36aa1dfa30,26097,05000US26097,Mackinac County,"Mackinac County, Michigan",10817,5463,5354
5ea728146307ba36aa1dfa31,26099,05000US26099,Macomb County,"Macomb County, Michigan",868704,422835,445869
5ea728146307ba36aa1dfa32,26101,05000US26101,Manistee County,"Manistee County, Michigan",24444,12658,11786
5ea728146307ba36aa1dfa33,26103,05000US26103,Marquette County,"Marquette County, Michigan",66939,33703,33236
5ea728146307ba36aa1dfa34,26105,05000US26105,Mason County,"Mason County, Michigan",28884,14310,14574
5ea728146307ba36aa1dfa35,26107,05000US26107,Mecosta County,"Mecosta County, Michigan",43264,21844,21420
5ea728146307ba36aa1dfa36,26109,05000US26109,Menominee County,"Menominee County, Michigan",23234,11781,11453
5ea728146307ba36aa1dfa37,26111,05000US26111,Midland County,"Midland County, Michigan",83389,40980,42409
5ea728146307ba36aa1dfa38,26113,05000US26113,Missaukee County,"Missaukee County, Michigan",15006,7668,7338
5ea728146307ba36aa1dfa39,26115,05000US26115,Monroe County,"Monroe County, Michigan",149699,73914,75785
5ea728146307ba36aa1dfa3a,26117,05000US26117,Montcalm County,"Montcalm County, Michigan",63209,32595,30614
5ea728146307ba36aa1dfa3b,26119,05000US26119,Montmorency County,"Montmorency County, Michigan",9261,4665,4596
5ea728146307ba36aa1dfa3c,26121,05000US26121,Muskegon County,"Muskegon County, Michigan",173043,86083,86960
5ea728146307ba36aa1dfa3d,26123,05000US26123,Newaygo County,"Newaygo County, Michigan",48142,24149,23993
5ea728146307ba36aa1dfa3e,26125,05000US26125,Oakland County,"Oakland County, Michigan",1250843,610771,640072
5ea728146307ba36aa1dfa3f,26127,05000US26127,Oceana County,"Oceana County, Michigan",26417,13412,13005
5ea728146307ba36aa1dfa40,26129,05000US26129,Ogemaw County,"Ogemaw County, Michigan",20928,10480,10448
5ea728146307ba36aa1dfa41,26131,05000US26131,Ontonagon County,"Ontonagon County, Michigan",5968,3054,2914
5ea728146307ba36aa1dfa42,26133,05000US26133,Osceola County,"Osceola County, Michigan",23232,11738,11494
5ea728146307ba36aa1dfa43,26135,05000US26135,Oscoda County,"Oscoda County, Michigan",8277,4251,4026
5ea728146307ba36aa1dfa44,26137,05000US26137,Otsego County,"Otsego County, Michigan",24397,12061,12336
5ea728146307ba36aa1dfa45,26139,05000US26139,Ottawa County,"Ottawa County, Michigan",284034,140285,143749
5ea728146307ba36aa1dfa46,26141,05000US26141,Presque Isle County,"Presque Isle County, Michigan",12797,6386,6411
5ea728146307ba36aa1dfa47,26143,05000US26143,Roscommon County,"Roscommon County, Michigan",23877,11857,12020
5ea728146307ba36aa1dfa48,26145,05000US26145,Saginaw County,"Saginaw County, Michigan",192778,93581,99197
5ea728146307ba36aa1dfa49,26147,05000US26147,St. Clair County,"St. Clair County, Michigan",159566,79300,80266
5ea728146307ba36aa1dfa4a,26149,05000US26149,St. Joseph County,"St. Joseph County, Michigan",60897,30259,30638
5ea728146307ba36aa1dfa4b,26151,05000US26151,Sanilac County,"Sanilac County, Michigan",41376,20534,20842
5ea728146307ba36aa1dfa4c,26153,05000US26153,Schoolcraft County,"Schoolcraft County, Michigan",8069,3984,4085
5ea728146307ba36aa1dfa4d,26155,05000US26155,Shiawassee County,"Shiawassee County, Michigan",68493,33801,34692
5ea728146307ba36aa1dfa4e,26157,05000US26157,Tuscola County,"Tuscola County, Michigan",53250,26732,26518
5ea728146307ba36aa1dfa4f,26159,05000US26159,Van Buren County,"Van Buren County, Michigan",75272,37429,37843
5ea728146307ba36aa1dfa50,26161,05000US26161,Washtenaw County,"Washtenaw County, Michigan",365961,181376,184585
5ea728146307ba36aa1dfa51,26163,05000US26163,Wayne County,"Wayne County, Michigan",1761382,847648,913734
5ea728146307ba36aa1dfa52,26165,05000US26165,Wexford County,"Wexford County, Michigan",33111,16567,16544
5ea728146307ba36aa1dfa53,27001,05000US27001,Aitkin County,"Aitkin County, Minnesota",15834,8053,7781
5ea728146307ba36aa1dfa54,27003,05000US27003,Anoka County,"Anoka County, Minnesota",347431,173811,173620
5ea728146307ba36aa1dfa55,27005,05000US27005,Becker County,"Becker County, Minnesota",33773,16783,16990
5ea728146307ba36aa1dfa56,27007,05000US27007,Beltrami County,"Beltrami County, Minnesota",46117,22906,23211
5ea728146307ba36aa1dfa57,27009,05000US27009,Benton County,"Benton County, Minnesota",39779,19894,19885
5ea728146307ba36aa1dfa58,27011,05000US27011,Big Stone County,"Big Stone County, Minnesota",5016,2477,2539
5ea728146307ba36aa1dfa59,27013,05000US27013,Blue Earth County,"Blue Earth County, Minnesota",66322,33323,32999
5ea728146307ba36aa1dfa5a,27015,05000US27015,Brown County,"Brown County, Minnesota",25211,12653,12558
5ea728146307ba36aa1dfa5b,27017,05000US27017,Carlton County,"Carlton County, Minnesota",35540,18565,16975
5ea728146307ba36aa1dfa5c,27019,05000US27019,Carver County,"Carver County, Minnesota",100416,49793,50623
5ea728146307ba36aa1dfa5d,27021,05000US27021,Cass County,"Cass County, Minnesota",29022,14798,14224
5ea728146307ba36aa1dfa5e,27023,05000US27023,Chippewa County,"Chippewa County, Minnesota",12010,5959,6051
5ea728146307ba36aa1dfa5f,27025,05000US27025,Chisago County,"Chisago County, Minnesota",54727,28333,26394
5ea728146307ba36aa1dfa60,27027,05000US27027,Clay County,"Clay County, Minnesota",62801,31010,31791
5ea728146307ba36aa1dfa61,27029,05000US27029,Clearwater County,"Clearwater County, Minnesota",8812,4504,4308
5ea728146307ba36aa1dfa62,27031,05000US27031,Cook County,"Cook County, Minnesota",5311,2632,2679
5ea728146307ba36aa1dfa63,27033,05000US27033,Cottonwood County,"Cottonwood County, Minnesota",11372,5662,5710
5ea728146307ba36aa1dfa64,27035,05000US27035,Crow Wing County,"Crow Wing County, Minnesota",63855,31966,31889
5ea728146307ba36aa1dfa65,27037,05000US27037,Dakota County,"Dakota County, Minnesota",418201,205909,212292
5ea728146307ba36aa1dfa66,27039,05000US27039,Dodge County,"Dodge County, Minnesota",20582,10334,10248
5ea728146307ba36aa1dfa67,27041,05000US27041,Douglas County,"Douglas County, Minnesota",37203,18607,18596
5ea728146307ba36aa1dfa68,27043,05000US27043,Faribault County,"Faribault County, Minnesota",13896,6949,6947
5ea728146307ba36aa1dfa69,27045,05000US27045,Fillmore County,"Fillmore County, Minnesota",20888,10491,10397
5ea728146307ba36aa1dfa6a,27047,05000US27047,Freeborn County,"Freeborn County, Minnesota",30526,15217,15309
5ea728146307ba36aa1dfa6b,27049,05000US27049,Goodhue County,"Goodhue County, Minnesota",46217,23093,23124
5ea728146307ba36aa1dfa6c,27051,05000US27051,Grant County,"Grant County, Minnesota",5938,3020,2918
5ea728146307ba36aa1dfa6d,27053,05000US27053,Hennepin County,"Hennepin County, Minnesota",1235478,610530,624948
5ea728146307ba36aa1dfa6e,27055,05000US27055,Houston County,"Houston County, Minnesota",18663,9349,9314
5ea728146307ba36aa1dfa6f,27057,05000US27057,Hubbard County,"Hubbard County, Minnesota",20862,10550,10312
5ea728146307ba36aa1dfa70,27059,05000US27059,Isanti County,"Isanti County, Minnesota",38974,19720,19254
5ea728146307ba36aa1dfa71,27061,05000US27061,Itasca County,"Itasca County, Minnesota",45203,22913,22290
5ea728146307ba36aa1dfa72,27063,05000US27063,Jackson County,"Jackson County, Minnesota",10047,5069,4978
5ea728146307ba36aa1dfa73,27065,05000US27065,Kanabec County,"Kanabec County, Minnesota",16004,8133,7871
5ea728146307ba36aa1dfa74,27067,05000US27067,Kandiyohi County,"Kandiyohi County, Minnesota",42658,21430,21228
5ea728146307ba36aa1dfa75,27069,05000US27069,Kittson County,"Kittson County, Minnesota",4337,2199,2138
5ea728146307ba36aa1dfa76,27071,05000US27071,Koochiching County,"Koochiching County, Minnesota",12644,6327,6317
5ea728146307ba36aa1dfa77,27073,05000US27073,Lac qui Parle County,"Lac qui Parle County, Minnesota",6773,3377,3396
5ea728146307ba36aa1dfa78,27075,05000US27075,Lake County,"Lake County, Minnesota",10569,5428,5141
5ea728146307ba36aa1dfa79,27077,05000US27077,Lake of the Woods County,"Lake of the Woods County, Minnesota",3809,2037,1772
5ea728146307ba36aa1dfa7a,27079,05000US27079,Le Sueur County,"Le Sueur County, Minnesota",27983,14106,13877
5ea728146307ba36aa1dfa7b,27081,05000US27081,Lincoln County,"Lincoln County, Minnesota",5707,2855,2852
5ea728146307ba36aa1dfa7c,27083,05000US27083,Lyon County,"Lyon County, Minnesota",25839,12788,13051
5ea728146307ba36aa1dfa7d,27085,05000US27085,McLeod County,"McLeod County, Minnesota",35825,17922,17903
5ea728146307ba36aa1dfa7e,27087,05000US27087,Mahnomen County,"Mahnomen County, Minnesota",5506,2728,2778
5ea728146307ba36aa1dfa7f,27089,05000US27089,Marshall County,"Marshall County, Minnesota",9392,4761,4631
5ea728146307ba36aa1dfa80,27091,05000US27091,Martin County,"Martin County, Minnesota",19964,10068,9896
5ea728146307ba36aa1dfa81,27093,05000US27093,Meeker County,"Meeker County, Minnesota",23079,11727,11352
5ea728146307ba36aa1dfa82,27095,05000US27095,Mille Lacs County,"Mille Lacs County, Minnesota",25728,12866,12862
5ea728146307ba36aa1dfa83,27097,05000US27097,Morrison County,"Morrison County, Minnesota",32949,16639,16310
5ea728146307ba36aa1dfa84,27099,05000US27099,Mower County,"Mower County, Minnesota",39602,20045,19557
5ea728146307ba36aa1dfa85,27101,05000US27101,Murray County,"Murray County, Minnesota",8353,4170,4183
5ea728146307ba36aa1dfa86,27103,05000US27103,Nicollet County,"Nicollet County, Minnesota",33783,16937,16846
5ea728146307ba36aa1dfa87,27105,05000US27105,Nobles County,"Nobles County, Minnesota",21839,11236,10603
5ea728146307ba36aa1dfa88,27107,05000US27107,Norman County,"Norman County, Minnesota",6559,3324,3235
5ea728146307ba36aa1dfa89,27109,05000US27109,Olmsted County,"Olmsted County, Minnesota",153065,74836,78229
5ea728146307ba36aa1dfa8a,27111,05000US27111,Otter Tail County,"Otter Tail County, Minnesota",57992,29263,28729
5ea728146307ba36aa1dfa8b,27113,05000US27113,Pennington County,"Pennington County, Minnesota",14184,7054,7130
5ea728146307ba36aa1dfa8c,27115,05000US27115,Pine County,"Pine County, Minnesota",29129,15648,13481
5ea728146307ba36aa1dfa8d,27117,05000US27117,Pipestone County,"Pipestone County, Minnesota",9185,4441,4744
5ea728146307ba36aa1dfa8e,27119,05000US27119,Polk County,"Polk County, Minnesota",31591,15967,15624
5ea728146307ba36aa1dfa8f,27121,05000US27121,Pope County,"Pope County, Minnesota",10980,5562,5418
5ea728146307ba36aa1dfa90,27123,05000US27123,Ramsey County,"Ramsey County, Minnesota",541493,263843,277650
5ea728146307ba36aa1dfa91,27125,05000US27125,Red Lake County,"Red Lake County, Minnesota",4008,2034,1974
5ea728146307ba36aa1dfa92,27127,05000US27127,Redwood County,"Redwood County, Minnesota",15331,7719,7612
5ea728146307ba36aa1dfa93,27129,05000US27129,Renville County,"Renville County, Minnesota",14721,7495,7226
5ea728146307ba36aa1dfa94,27131,05000US27131,Rice County,"Rice County, Minnesota",65765,33580,32185
5ea728146307ba36aa1dfa95,27133,05000US27133,Rock County,"Rock County, Minnesota",9413,4625,4788
5ea728146307ba36aa1dfa96,27135,05000US27135,Roseau County,"Roseau County, Minnesota",15462,8003,7459
5ea728146307ba36aa1dfa97,27137,05000US27137,St. Louis County,"St. Louis County, Minnesota",200080,100487,99593
5ea728146307ba36aa1dfa98,27139,05000US27139,Scott County,"Scott County, Minnesota",143372,71406,71966
5ea728146307ba36aa1dfa99,27141,05000US27141,Sherburne County,"Sherburne County, Minnesota",93231,47673,45558
5ea728146307ba36aa1dfa9a,27143,05000US27143,Sibley County,"Sibley County, Minnesota",14912,7570,7342
5ea728146307ba36aa1dfa9b,27145,05000US27145,Stearns County,"Stearns County, Minnesota",156819,78931,77888
5ea728146307ba36aa1dfa9c,27147,05000US27147,Steele County,"Steele County, Minnesota",36676,18171,18505
5ea728146307ba36aa1dfa9d,27149,05000US27149,Stevens County,"Stevens County, Minnesota",9784,4910,4874
5ea728146307ba36aa1dfa9e,27151,05000US27151,Swift County,"Swift County, Minnesota",9411,4726,4685
5ea728146307ba36aa1dfa9f,27153,05000US27153,Todd County,"Todd County, Minnesota",24440,12563,11877
5ea728146307ba36aa1dfaa0,27155,05000US27155,Traverse County,"Traverse County, Minnesota",3337,1644,1693
5ea728146307ba36aa1dfaa1,27157,05000US27157,Wabasha County,"Wabasha County, Minnesota",21500,10779,10721
5ea728146307ba36aa1dfaa2,27159,05000US27159,Wadena County,"Wadena County, Minnesota",13646,6727,6919
5ea728146307ba36aa1dfaa3,27161,05000US27161,Waseca County,"Waseca County, Minnesota",18809,9000,9809
5ea728146307ba36aa1dfaa4,27163,05000US27163,Washington County,"Washington County, Minnesota",253317,125332,127985
5ea728146307ba36aa1dfaa5,27165,05000US27165,Watonwan County,"Watonwan County, Minnesota",10973,5408,5565
5ea728146307ba36aa1dfaa6,27167,05000US27167,Wilkin County,"Wilkin County, Minnesota",6343,3215,3128
5ea728146307ba36aa1dfaa7,27169,05000US27169,Winona County,"Winona County, Minnesota",50847,25191,25656
5ea728146307ba36aa1dfaa8,27171,05000US27171,Wright County,"Wright County, Minnesota",132745,66913,65832
5ea728146307ba36aa1dfaa9,27173,05000US27173,Yellow Medicine County,"Yellow Medicine County, Minnesota",9868,5056,4812
5ea728146307ba36aa1dfaaa,28001,05000US28001,Adams County,"Adams County, Mississippi",31547,16217,15330
5ea728146307ba36aa1dfaab,28003,05000US28003,Alcorn County,"Alcorn County, Mississippi",37180,18287,18893
5ea728146307ba36aa1dfaac,28005,05000US28005,Amite County,"Amite County, Mississippi",12468,6007,6461
5ea728146307ba36aa1dfaad,28007,05000US28007,Attala County,"Attala County, Mississippi",18581,8826,9755
5ea728146307ba36aa1dfaae,28009,05000US28009,Benton County,"Benton County, Mississippi",8253,4122,4131
5ea728146307ba36aa1dfaaf,28011,05000US28011,Bolivar County,"Bolivar County, Mississippi",32592,15365,17227
5ea728146307ba36aa1dfab0,28013,05000US28013,Calhoun County,"Calhoun County, Mississippi",14571,6991,7580
5ea728146307ba36aa1dfab1,28015,05000US28015,Carroll County,"Carroll County, Mississippi",10129,5116,5013
5ea728146307ba36aa1dfab2,28017,05000US28017,Chickasaw County,"Chickasaw County, Mississippi",17279,8331,8948
5ea728146307ba36aa1dfab3,28019,05000US28019,Choctaw County,"Choctaw County, Mississippi",8321,4174,4147
5ea728146307ba36aa1dfab4,28021,05000US28021,Claiborne County,"Claiborne County, Mississippi",9120,4312,4808
5ea728146307ba36aa1dfab5,28023,05000US28023,Clarke County,"Clarke County, Mississippi",15928,7443,8485
5ea728146307ba36aa1dfab6,28025,05000US28025,Clay County,"Clay County, Mississippi",19808,9177,10631
5ea728146307ba36aa1dfab7,28027,05000US28027,Coahoma County,"Coahoma County, Mississippi",23802,11006,12796
5ea728146307ba36aa1dfab8,28029,05000US28029,Copiah County,"Copiah County, Mississippi",28721,13704,15017
5ea728146307ba36aa1dfab9,28031,05000US28031,Covington County,"Covington County, Mississippi",19091,9252,9839
5ea728146307ba36aa1dfaba,28033,05000US28033,DeSoto County,"DeSoto County, Mississippi",176132,85174,90958
5ea728146307ba36aa1dfabb,28035,05000US28035,Forrest County,"Forrest County, Mississippi",75517,35944,39573
5ea728146307ba36aa1dfabc,28037,05000US28037,Franklin County,"Franklin County, Mississippi",7757,3706,4051
5ea728146307ba36aa1dfabd,28039,05000US28039,George County,"George County, Mississippi",23710,12008,11702
5ea728146307ba36aa1dfabe,28041,05000US28041,Greene County,"Greene County, Mississippi",13714,8294,5420
5ea728146307ba36aa1dfabf,28043,05000US28043,Grenada County,"Grenada County, Mississippi",21278,10103,11175
5ea728146307ba36aa1dfac0,28045,05000US28045,Hancock County,"Hancock County, Mississippi",46653,22779,23874
5ea728146307ba36aa1dfac1,28047,05000US28047,Harrison County,"Harrison County, Mississippi",202626,99750,102876
5ea728146307ba36aa1dfac2,28049,05000US28049,Hinds County,"Hinds County, Mississippi",241774,112877,128897
5ea728146307ba36aa1dfac3,28051,05000US28051,Holmes County,"Holmes County, Mississippi",18075,8635,9440
5ea728146307ba36aa1dfac4,28053,05000US28053,Humphreys County,"Humphreys County, Mississippi",8539,3990,4549
5ea728146307ba36aa1dfac5,28055,05000US28055,Issaquena County,"Issaquena County, Mississippi",1328,807,521
5ea728146307ba36aa1dfac6,28057,05000US28057,Itawamba County,"Itawamba County, Mississippi",23480,11821,11659
5ea728146307ba36aa1dfac7,28059,05000US28059,Jackson County,"Jackson County, Mississippi",142014,70065,71949
5ea728146307ba36aa1dfac8,28061,05000US28061,Jasper County,"Jasper County, Mississippi",16529,8048,8481
5ea728146307ba36aa1dfac9,28063,05000US28063,Jefferson County,"Jefferson County, Mississippi",7346,3642,3704
5ea728146307ba36aa1dfaca,28065,05000US28065,Jefferson Davis County,"Jefferson Davis County, Mississippi",11495,5543,5952
5ea728146307ba36aa1dfacb,28067,05000US28067,Jones County,"Jones County, Mississippi",68454,33352,35102
5ea728146307ba36aa1dfacc,28069,05000US28069,Kemper County,"Kemper County, Mississippi",10107,5170,4937
5ea728146307ba36aa1dfacd,28071,05000US28071,Lafayette County,"Lafayette County, Mississippi",53459,25974,27485
5ea728146307ba36aa1dface,28073,05000US28073,Lamar County,"Lamar County, Mississippi",61223,29243,31980
5ea728146307ba36aa1dfacf,28075,05000US28075,Lauderdale County,"Lauderdale County, Mississippi",77323,37617,39706
5ea728146307ba36aa1dfad0,28077,05000US28077,Lawrence County,"Lawrence County, Mississippi",12630,6130,6500
5ea728146307ba36aa1dfad1,28079,05000US28079,Leake County,"Leake County, Mississippi",22870,11533,11337
5ea728146307ba36aa1dfad2,28081,05000US28081,Lee County,"Lee County, Mississippi",84915,40526,44389
5ea728146307ba36aa1dfad3,28083,05000US28083,Leflore County,"Leflore County, Mississippi",29804,13916,15888
5ea728146307ba36aa1dfad4,28085,05000US28085,Lincoln County,"Lincoln County, Mississippi",34432,16255,18177
5ea728146307ba36aa1dfad5,28087,05000US28087,Lowndes County,"Lowndes County, Mississippi",59437,28365,31072
5ea728146307ba36aa1dfad6,28089,05000US28089,Madison County,"Madison County, Mississippi",103498,49524,53974
5ea728146307ba36aa1dfad7,28091,05000US28091,Marion County,"Marion County, Mississippi",25202,12230,12972
5ea728146307ba36aa1dfad8,28093,05000US28093,Marshall County,"Marshall County, Mississippi",35787,17736,18051
5ea728146307ba36aa1dfad9,28095,05000US28095,Monroe County,"Monroe County, Mississippi",35840,17107,18733
5ea728146307ba36aa1dfada,28097,05000US28097,Montgomery County,"Montgomery County, Mississippi",10198,4769,5429
5ea728146307ba36aa1dfadb,28099,05000US28099,Neshoba County,"Neshoba County, Mississippi",29376,13988,15388
5ea728146307ba36aa1dfadc,28101,05000US28101,Newton County,"Newton County, Mississippi",21524,10142,11382
5ea728146307ba36aa1dfadd,28103,05000US28103,Noxubee County,"Noxubee County, Mississippi",10828,5127,5701
5ea728146307ba36aa1dfade,28105,05000US28105,Oktibbeha County,"Oktibbeha County, Mississippi",49481,24863,24618
5ea728146307ba36aa1dfadf,28107,05000US28107,Panola County,"Panola County, Mississippi",34243,16549,17694
5ea728146307ba36aa1dfae0,28109,05000US28109,Pearl River County,"Pearl River County, Mississippi",55149,27263,27886
5ea728146307ba36aa1dfae1,28111,05000US28111,Perry County,"Perry County, Mississippi",12028,5845,6183
5ea728146307ba36aa1dfae2,28113,05000US28113,Pike County,"Pike County, Mississippi",39737,18836,20901
5ea728146307ba36aa1dfae3,28115,05000US28115,Pontotoc County,"Pontotoc County, Mississippi",31315,15304,16011
5ea728146307ba36aa1dfae4,28117,05000US28117,Prentiss County,"Prentiss County, Mississippi",25360,12304,13056
5ea728146307ba36aa1dfae5,28119,05000US28119,Quitman County,"Quitman County, Mississippi",7372,3476,3896
5ea728146307ba36aa1dfae6,28121,05000US28121,Rankin County,"Rankin County, Mississippi",151240,73041,78199
5ea728146307ba36aa1dfae7,28123,05000US28123,Scott County,"Scott County, Mississippi",28415,13870,14545
5ea728146307ba36aa1dfae8,28125,05000US28125,Sharkey County,"Sharkey County, Mississippi",4511,2147,2364
5ea728146307ba36aa1dfae9,28127,05000US28127,Simpson County,"Simpson County, Mississippi",27073,13115,13958
5ea728146307ba36aa1dfaea,28129,05000US28129,Smith County,"Smith County, Mississippi",16063,7847,8216
5ea728146307ba36aa1dfaeb,28131,05000US28131,Stone County,"Stone County, Mississippi",18375,9367,9008
5ea728146307ba36aa1dfaec,28133,05000US28133,Sunflower County,"Sunflower County, Mississippi",26532,13927,12605
5ea728146307ba36aa1dfaed,28135,05000US28135,Tallahatchie County,"Tallahatchie County, Mississippi",14361,8012,6349
5ea728146307ba36aa1dfaee,28137,05000US28137,Tate County,"Tate County, Mississippi",28493,13828,14665
5ea728146307ba36aa1dfaef,28139,05000US28139,Tippah County,"Tippah County, Mississippi",21990,10673,11317
5ea728146307ba36aa1dfaf0,28141,05000US28141,Tishomingo County,"Tishomingo County, Mississippi",19478,9491,9987
5ea728146307ba36aa1dfaf1,28143,05000US28143,Tunica County,"Tunica County, Mississippi",10170,4659,5511
5ea728146307ba36aa1dfaf2,28145,05000US28145,Union County,"Union County, Mississippi",28356,13942,14414
5ea728146307ba36aa1dfaf3,28147,05000US28147,Walthall County,"Walthall County, Mississippi",14601,7108,7493
5ea728146307ba36aa1dfaf4,28149,05000US28149,Warren County,"Warren County, Mississippi",47075,22428,24647
5ea728146307ba36aa1dfaf5,28151,05000US28151,Washington County,"Washington County, Mississippi",47086,22018,25068
5ea728146307ba36aa1dfaf6,28153,05000US28153,Wayne County,"Wayne County, Mississippi",20422,10072,10350
5ea728146307ba36aa1dfaf7,28155,05000US28155,Webster County,"Webster County, Mississippi",9828,4788,5040
5ea728146307ba36aa1dfaf8,28157,05000US28157,Wilkinson County,"Wilkinson County, Mississippi",8990,4816,4174
5ea728146307ba36aa1dfaf9,28159,05000US28159,Winston County,"Winston County, Mississippi",18358,8942,9416
5ea728146307ba36aa1dfafa,28161,05000US28161,Yalobusha County,"Yalobusha County, Mississippi",12421,6085,6336
5ea728146307ba36aa1dfafb,28163,05000US28163,Yazoo County,"Yazoo County, Mississippi",27974,15543,12431
5ea728146307ba36aa1dfafc,29001,05000US29001,Adair County,"Adair County, Missouri",25325,12215,13110
5ea728146307ba36aa1dfafd,29003,05000US29003,Andrew County,"Andrew County, Missouri",17403,8720,8683
5ea728146307ba36aa1dfafe,29005,05000US29005,Atchison County,"Atchison County, Missouri",5270,2615,2655
5ea728146307ba36aa1dfaff,29007,05000US29007,Audrain County,"Audrain County, Missouri",25735,11768,13967
5ea728146307ba36aa1dfb00,29009,05000US29009,Barry County,"Barry County, Missouri",35493,17823,17670
5ea728146307ba36aa1dfb01,29011,05000US29011,Barton County,"Barton County, Missouri",11850,5865,5985
5ea728146307ba36aa1dfb02,29013,05000US29013,Bates County,"Bates County, Missouri",16374,8014,8360
5ea728146307ba36aa1dfb03,29015,05000US29015,Benton County,"Benton County, Missouri",18989,9354,9635
5ea728146307ba36aa1dfb04,29017,05000US29017,Bollinger County,"Bollinger County, Missouri",12281,6140,6141
5ea728146307ba36aa1dfb05,29019,05000US29019,Boone County,"Boone County, Missouri",176515,85827,90688
5ea728146307ba36aa1dfb06,29021,05000US29021,Buchanan County,"Buchanan County, Missouri",89076,44691,44385
5ea728146307ba36aa1dfb07,29023,05000US29023,Butler County,"Butler County, Missouri",42733,20823,21910
5ea728146307ba36aa1dfb08,29025,05000US29025,Caldwell County,"Caldwell County, Missouri",9049,4585,4464
5ea728146307ba36aa1dfb09,29027,05000US29027,Callaway County,"Callaway County, Missouri",44840,22874,21966
5ea728146307ba36aa1dfb0a,29029,05000US29029,Camden County,"Camden County, Missouri",45096,22328,22768
5ea728146307ba36aa1dfb0b,29031,05000US29031,Cape Girardeau County,"Cape Girardeau County, Missouri",78324,37932,40392
5ea728146307ba36aa1dfb0c,29033,05000US29033,Carroll County,"Carroll County, Missouri",8843,4330,4513
5ea728146307ba36aa1dfb0d,29035,05000US29035,Carter County,"Carter County, Missouri",6197,3010,3187
5ea728146307ba36aa1dfb0e,29037,05000US29037,Cass County,"Cass County, Missouri",102678,50364,52314
5ea728146307ba36aa1dfb0f,29039,05000US29039,Cedar County,"Cedar County, Missouri",13938,6961,6977
5ea728146307ba36aa1dfb10,29041,05000US29041,Chariton County,"Chariton County, Missouri",7546,3764,3782
5ea728146307ba36aa1dfb11,29043,05000US29043,Christian County,"Christian County, Missouri",84275,40995,43280
5ea728146307ba36aa1dfb12,29045,05000US29045,Clark County,"Clark County, Missouri",6800,3447,3353
5ea728146307ba36aa1dfb13,29047,05000US29047,Clay County,"Clay County, Missouri",239164,117296,121868
5ea728146307ba36aa1dfb14,29049,05000US29049,Clinton County,"Clinton County, Missouri",20475,10266,10209
5ea728146307ba36aa1dfb15,29051,05000US29051,Cole County,"Cole County, Missouri",76740,38731,38009
5ea728146307ba36aa1dfb16,29053,05000US29053,Cooper County,"Cooper County, Missouri",17622,9214,8408
5ea728146307ba36aa1dfb17,29055,05000US29055,Crawford County,"Crawford County, Missouri",24280,11969,12311
5ea728146307ba36aa1dfb18,29057,05000US29057,Dade County,"Dade County, Missouri",7590,3884,3706
5ea728146307ba36aa1dfb19,29059,05000US29059,Dallas County,"Dallas County, Missouri",16499,8212,8287
5ea728146307ba36aa1dfb1a,29061,05000US29061,Daviess County,"Daviess County, Missouri",8302,4187,4115
5ea728146307ba36aa1dfb1b,29063,05000US29063,DeKalb County,"DeKalb County, Missouri",12564,7947,4617
5ea728146307ba36aa1dfb1c,29065,05000US29065,Dent County,"Dent County, Missouri",15504,7692,7812
5ea728146307ba36aa1dfb1d,29067,05000US29067,Douglas County,"Douglas County, Missouri",13374,6700,6674
5ea728146307ba36aa1dfb1e,29069,05000US29069,Dunklin County,"Dunklin County, Missouri",30428,14623,15805
5ea728146307ba36aa1dfb1f,29071,05000US29071,Franklin County,"Franklin County, Missouri",102781,51339,51442
5ea728146307ba36aa1dfb20,29073,05000US29073,Gasconade County,"Gasconade County, Missouri",14746,7373,7373
5ea728146307ba36aa1dfb21,29075,05000US29075,Gentry County,"Gentry County, Missouri",6665,3218,3447
5ea728146307ba36aa1dfb22,29077,05000US29077,Greene County,"Greene County, Missouri",288429,140366,148063
5ea728146307ba36aa1dfb23,29079,05000US29079,Grundy County,"Grundy County, Missouri",10039,4906,5133
5ea728146307ba36aa1dfb24,29081,05000US29081,Harrison County,"Harrison County, Missouri",8554,4263,4291
5ea728146307ba36aa1dfb25,29083,05000US29083,Henry County,"Henry County, Missouri",21765,10643,11122
5ea728146307ba36aa1dfb26,29085,05000US29085,Hickory County,"Hickory County, Missouri",9368,4551,4817
5ea728146307ba36aa1dfb27,29087,05000US29087,Holt County,"Holt County, Missouri",4456,2197,2259
5ea728146307ba36aa1dfb28,29089,05000US29089,Howard County,"Howard County, Missouri",10113,5042,5071
5ea728146307ba36aa1dfb29,29091,05000US29091,Howell County,"Howell County, Missouri",40102,19640,20462
5ea728146307ba36aa1dfb2a,29093,05000US29093,Iron County,"Iron County, Missouri",10221,5029,5192
5ea728146307ba36aa1dfb2b,29095,05000US29095,Jackson County,"Jackson County, Missouri",692003,334604,357399
5ea728146307ba36aa1dfb2c,29097,05000US29097,Jasper County,"Jasper County, Missouri",119238,58223,61015
5ea728146307ba36aa1dfb2d,29099,05000US29099,Jefferson County,"Jefferson County, Missouri",223302,110887,112415
5ea728146307ba36aa1dfb2e,29101,05000US29101,Johnson County,"Johnson County, Missouri",53689,27715,25974
5ea728146307ba36aa1dfb2f,29103,05000US29103,Knox County,"Knox County, Missouri",3951,1989,1962
5ea728146307ba36aa1dfb30,29105,05000US29105,Laclede County,"Laclede County, Missouri",35507,17578,17929
5ea728146307ba36aa1dfb31,29107,05000US29107,Lafayette County,"Lafayette County, Missouri",32589,16106,16483
5ea728146307ba36aa1dfb32,29109,05000US29109,Lawrence County,"Lawrence County, Missouri",38133,18995,19138
5ea728146307ba36aa1dfb33,29111,05000US29111,Lewis County,"Lewis County, Missouri",10027,5100,4927
5ea728146307ba36aa1dfb34,29113,05000US29113,Lincoln County,"Lincoln County, Missouri",55563,27526,28037
5ea728146307ba36aa1dfb35,29115,05000US29115,Linn County,"Linn County, Missouri",12186,5861,6325
5ea728146307ba36aa1dfb36,29117,05000US29117,Livingston County,"Livingston County, Missouri",15076,6813,8263
5ea728146307ba36aa1dfb37,29119,05000US29119,McDonald County,"McDonald County, Missouri",22827,11635,11192
5ea728146307ba36aa1dfb38,29121,05000US29121,Macon County,"Macon County, Missouri",15254,7683,7571
5ea728146307ba36aa1dfb39,29123,05000US29123,Madison County,"Madison County, Missouri",12205,6049,6156
5ea728146307ba36aa1dfb3a,29125,05000US29125,Maries County,"Maries County, Missouri",8884,4449,4435
5ea728146307ba36aa1dfb3b,29127,05000US29127,Marion County,"Marion County, Missouri",28672,13745,14927
5ea728146307ba36aa1dfb3c,29129,05000US29129,Mercer County,"Mercer County, Missouri",3664,1834,1830
5ea728146307ba36aa1dfb3d,29131,05000US29131,Miller County,"Miller County, Missouri",25049,12314,12735
5ea728146307ba36aa1dfb3e,29133,05000US29133,Mississippi County,"Mississippi County, Missouri",13748,7575,6173
5ea728146307ba36aa1dfb3f,29135,05000US29135,Moniteau County,"Moniteau County, Missouri",15958,8413,7545
5ea728146307ba36aa1dfb40,29137,05000US29137,Monroe County,"Monroe County, Missouri",8654,4402,4252
5ea728146307ba36aa1dfb41,29139,05000US29139,Montgomery County,"Montgomery County, Missouri",11545,5764,5781
5ea728146307ba36aa1dfb42,29141,05000US29141,Morgan County,"Morgan County, Missouri",20137,9945,10192
5ea728146307ba36aa1dfb43,29143,05000US29143,New Madrid County,"New Madrid County, Missouri",17811,8558,9253
5ea728146307ba36aa1dfb44,29145,05000US29145,Newton County,"Newton County, Missouri",58202,28964,29238
5ea728146307ba36aa1dfb45,29147,05000US29147,Nodaway County,"Nodaway County, Missouri",22547,11225,11322
5ea728146307ba36aa1dfb46,29149,05000US29149,Oregon County,"Oregon County, Missouri",10699,5376,5323
5ea728146307ba36aa1dfb47,29151,05000US29151,Osage County,"Osage County, Missouri",13619,7076,6543
5ea728146307ba36aa1dfb48,29153,05000US29153,Ozark County,"Ozark County, Missouri",9236,4592,4644
5ea728146307ba36aa1dfb49,29155,05000US29155,Pemiscot County,"Pemiscot County, Missouri",17031,8022,9009
5ea728146307ba36aa1dfb4a,29157,05000US29157,Perry County,"Perry County, Missouri",19146,9457,9689
5ea728146307ba36aa1dfb4b,29159,05000US29159,Pettis County,"Pettis County, Missouri",42371,20918,21453
5ea728146307ba36aa1dfb4c,29161,05000US29161,Phelps County,"Phelps County, Missouri",44789,23541,21248
5ea728146307ba36aa1dfb4d,29163,05000US29163,Pike County,"Pike County, Missouri",18489,10217,8272
5ea728146307ba36aa1dfb4e,29165,05000US29165,Platte County,"Platte County, Missouri",98824,48720,50104
5ea728146307ba36aa1dfb4f,29167,05000US29167,Polk County,"Polk County, Missouri",31549,15435,16114
5ea728146307ba36aa1dfb50,29169,05000US29169,Pulaski County,"Pulaski County, Missouri",52591,30025,22566
5ea728146307ba36aa1dfb51,29171,05000US29171,Putnam County,"Putnam County, Missouri",4815,2389,2426
5ea728146307ba36aa1dfb52,29173,05000US29173,Ralls County,"Ralls County, Missouri",10217,5178,5039
5ea728146307ba36aa1dfb53,29175,05000US29175,Randolph County,"Randolph County, Missouri",24945,13102,11843
5ea728146307ba36aa1dfb54,29177,05000US29177,Ray County,"Ray County, Missouri",22825,11357,11468
5ea728146307ba36aa1dfb55,29179,05000US29179,Reynolds County,"Reynolds County, Missouri",6315,3238,3077
5ea728146307ba36aa1dfb56,29181,05000US29181,Ripley County,"Ripley County, Missouri",13693,6817,6876
5ea728146307ba36aa1dfb57,29183,05000US29183,St. Charles County,"St. Charles County, Missouri",389985,191641,198344
5ea728146307ba36aa1dfb58,29185,05000US29185,St. Clair County,"St. Clair County, Missouri",9383,4663,4720
5ea728146307ba36aa1dfb59,29186,05000US29186,Ste. Genevieve County,"Ste. Genevieve County, Missouri",17871,8979,8892
5ea728146307ba36aa1dfb5a,29187,05000US29187,St. Francois County,"St. Francois County, Missouri",66342,35900,30442
5ea728146307ba36aa1dfb5b,29189,05000US29189,St. Louis County,"St. Louis County, Missouri",998684,473610,525074
5ea728146307ba36aa1dfb5c,29195,05000US29195,Saline County,"Saline County, Missouri",23102,11559,11543
5ea728146307ba36aa1dfb5d,29197,05000US29197,Schuyler County,"Schuyler County, Missouri",4502,2219,2283
5ea728146307ba36aa1dfb5e,29199,05000US29199,Scotland County,"Scotland County, Missouri",4898,2399,2499
5ea728146307ba36aa1dfb5f,29201,05000US29201,Scott County,"Scott County, Missouri",38729,18712,20017
5ea728146307ba36aa1dfb60,29203,05000US29203,Shannon County,"Shannon County, Missouri",8246,4012,4234
5ea728146307ba36aa1dfb61,29205,05000US29205,Shelby County,"Shelby County, Missouri",6061,3047,3014
5ea728146307ba36aa1dfb62,29207,05000US29207,Stoddard County,"Stoddard County, Missouri",29512,14365,15147
5ea728146307ba36aa1dfb63,29209,05000US29209,Stone County,"Stone County, Missouri",31527,15409,16118
5ea728146307ba36aa1dfb64,29211,05000US29211,Sullivan County,"Sullivan County, Missouri",6317,3052,3265
5ea728146307ba36aa1dfb65,29213,05000US29213,Taney County,"Taney County, Missouri",54720,26504,28216
5ea728146307ba36aa1dfb66,29215,05000US29215,Texas County,"Texas County, Missouri",25671,13397,12274
5ea728146307ba36aa1dfb67,29217,05000US29217,Vernon County,"Vernon County, Missouri",20691,10088,10603
5ea728146307ba36aa1dfb68,29219,05000US29219,Warren County,"Warren County, Missouri",33908,16714,17194
5ea728146307ba36aa1dfb69,29221,05000US29221,Washington County,"Washington County, Missouri",24931,12835,12096
5ea728146307ba36aa1dfb6a,29223,05000US29223,Wayne County,"Wayne County, Missouri",13308,6544,6764
5ea728146307ba36aa1dfb6b,29225,05000US29225,Webster County,"Webster County, Missouri",38082,19436,18646
5ea728146307ba36aa1dfb6c,29227,05000US29227,Worth County,"Worth County, Missouri",2040,981,1059
5ea728146307ba36aa1dfb6d,29229,05000US29229,Wright County,"Wright County, Missouri",18293,9029,9264
5ea728146307ba36aa1dfb6e,29510,05000US29510,St. Louis city,"St. Louis city, Missouri",311273,150532,160741
5ea728146307ba36aa1dfb6f,30001,05000US30001,Beaverhead County,"Beaverhead County, Montana",9393,4748,4645
5ea728146307ba36aa1dfb70,30003,05000US30003,Big Horn County,"Big Horn County, Montana",13376,6572,6804
5ea728146307ba36aa1dfb71,30005,05000US30005,Blaine County,"Blaine County, Montana",6727,3368,3359
5ea728146307ba36aa1dfb72,30007,05000US30007,Broadwater County,"Broadwater County, Montana",5834,2975,2859
5ea728146307ba36aa1dfb73,30009,05000US30009,Carbon County,"Carbon County, Montana",10546,5317,5229
5ea728146307ba36aa1dfb74,30011,05000US30011,Carter County,"Carter County, Montana",1318,649,669
5ea728146307ba36aa1dfb75,30013,05000US30013,Cascade County,"Cascade County, Montana",81746,41269,40477
5ea728146307ba36aa1dfb76,30015,05000US30015,Chouteau County,"Chouteau County, Montana",5789,2839,2950
5ea728146307ba36aa1dfb77,30017,05000US30017,Custer County,"Custer County, Montana",11845,5955,5890
5ea728146307ba36aa1dfb78,30019,05000US30019,Daniels County,"Daniels County, Montana",1753,884,869
5ea728146307ba36aa1dfb79,30021,05000US30021,Dawson County,"Dawson County, Montana",9191,4877,4314
5ea728146307ba36aa1dfb7a,30023,05000US30023,Deer Lodge County,"Deer Lodge County, Montana",9100,4835,4265
5ea728146307ba36aa1dfb7b,30025,05000US30025,Fallon County,"Fallon County, Montana",2838,1472,1366
5ea728146307ba36aa1dfb7c,30027,05000US30027,Fergus County,"Fergus County, Montana",11273,5682,5591
5ea728146307ba36aa1dfb7d,30029,05000US30029,Flathead County,"Flathead County, Montana",98082,48823,49259
5ea728146307ba36aa1dfb7e,30031,05000US30031,Gallatin County,"Gallatin County, Montana",104729,54246,50483
5ea728146307ba36aa1dfb7f,30033,05000US30033,Garfield County,"Garfield County, Montana",1141,605,536
5ea728146307ba36aa1dfb80,30035,05000US30035,Glacier County,"Glacier County, Montana",13699,6855,6844
5ea728146307ba36aa1dfb81,30037,05000US30037,Golden Valley County,"Golden Valley County, Montana",724,355,369
5ea728146307ba36aa1dfb82,30039,05000US30039,Granite County,"Granite County, Montana",3269,1696,1573
5ea728146307ba36aa1dfb83,30041,05000US30041,Hill County,"Hill County, Montana",16439,8292,8147
5ea728146307ba36aa1dfb84,30043,05000US30043,Jefferson County,"Jefferson County, Montana",11778,5979,5799
5ea728146307ba36aa1dfb85,30045,05000US30045,Judith Basin County,"Judith Basin County, Montana",1951,1058,893
5ea728146307ba36aa1dfb86,30047,05000US30047,Lake County,"Lake County, Montana",29774,14744,15030
5ea728146307ba36aa1dfb87,30049,05000US30049,Lewis and Clark County,"Lewis and Clark County, Montana",67077,33186,33891
5ea728146307ba36aa1dfb88,30051,05000US30051,Liberty County,"Liberty County, Montana",2280,1146,1134
5ea728146307ba36aa1dfb89,30053,05000US30053,Lincoln County,"Lincoln County, Montana",19358,9678,9680
5ea728146307ba36aa1dfb8a,30055,05000US30055,McCone County,"McCone County, Montana",1630,828,802
5ea728146307ba36aa1dfb8b,30057,05000US30057,Madison County,"Madison County, Montana",8218,4261,3957
5ea728146307ba36aa1dfb8c,30059,05000US30059,Meagher County,"Meagher County, Montana",1968,966,1002
5ea728146307ba36aa1dfb8d,30061,05000US30061,Mineral County,"Mineral County, Montana",4211,2135,2076
5ea728146307ba36aa1dfb8e,30063,05000US30063,Missoula County,"Missoula County, Montana",115983,58372,57611
5ea728146307ba36aa1dfb8f,30065,05000US30065,Musselshell County,"Musselshell County, Montana",4807,2399,2408
5ea728146307ba36aa1dfb90,30067,05000US30067,Park County,"Park County, Montana",16246,8164,8082
5ea728146307ba36aa1dfb91,30069,05000US30069,Petroleum County,"Petroleum County, Montana",432,229,203
5ea728146307ba36aa1dfb92,30071,05000US30071,Phillips County,"Phillips County, Montana",4124,2101,2023
5ea728146307ba36aa1dfb93,30073,05000US30073,Pondera County,"Pondera County, Montana",6044,3003,3041
5ea728146307ba36aa1dfb94,30075,05000US30075,Powder River County,"Powder River County, Montana",1619,820,799
5ea728146307ba36aa1dfb95,30077,05000US30077,Powell County,"Powell County, Montana",6861,4310,2551
5ea728146307ba36aa1dfb96,30079,05000US30079,Prairie County,"Prairie County, Montana",1342,673,669
5ea728146307ba36aa1dfb97,30081,05000US30081,Ravalli County,"Ravalli County, Montana",41902,20822,21080
5ea728146307ba36aa1dfb98,30083,05000US30083,Richland County,"Richland County, Montana",11360,5740,5620
5ea728146307ba36aa1dfb99,30085,05000US30085,Roosevelt County,"Roosevelt County, Montana",11228,5559,5669
5ea728146307ba36aa1dfb9a,30087,05000US30087,Rosebud County,"Rosebud County, Montana",9250,4608,4642
5ea728146307ba36aa1dfb9b,30089,05000US30089,Sanders County,"Sanders County, Montana",11521,5935,5586
5ea728146307ba36aa1dfb9c,30091,05000US30091,Sheridan County,"Sheridan County, Montana",3574,1794,1780
5ea728146307ba36aa1dfb9d,30093,05000US30093,Silver Bow County,"Silver Bow County, Montana",34814,17588,17226
5ea728146307ba36aa1dfb9e,30095,05000US30095,Stillwater County,"Stillwater County, Montana",9410,4693,4717
5ea728146307ba36aa1dfb9f,30097,05000US30097,Sweet Grass County,"Sweet Grass County, Montana",3653,1770,1883
5ea728146307ba36aa1dfba0,30099,05000US30099,Teton County,"Teton County, Montana",6080,2994,3086
5ea728146307ba36aa1dfba1,30101,05000US30101,Toole County,"Toole County, Montana",4976,2824,2152
5ea728146307ba36aa1dfba2,30103,05000US30103,Treasure County,"Treasure County, Montana",777,384,393
5ea728146307ba36aa1dfba3,30105,05000US30105,Valley County,"Valley County, Montana",7532,3730,3802
5ea728146307ba36aa1dfba4,30107,05000US30107,Wheatland County,"Wheatland County, Montana",2149,1079,1070
5ea728146307ba36aa1dfba5,30109,05000US30109,Wibaux County,"Wibaux County, Montana",1175,561,614
5ea728146307ba36aa1dfba6,30111,05000US30111,Yellowstone County,"Yellowstone County, Montana",157816,77773,80043
5ea728146307ba36aa1dfba7,31001,05000US31001,Adams County,"Adams County, Nebraska",31583,15947,15636
5ea728146307ba36aa1dfba8,31003,05000US31003,Antelope County,"Antelope County, Nebraska",6372,3204,3168
5ea728146307ba36aa1dfba9,31005,05000US31005,Arthur County,"Arthur County, Nebraska",418,205,213
5ea728146307ba36aa1dfbaa,31007,05000US31007,Banner County,"Banner County, Nebraska",696,346,350
5ea728146307ba36aa1dfbab,31009,05000US31009,Blaine County,"Blaine County, Nebraska",480,246,234
5ea728146307ba36aa1dfbac,31011,05000US31011,Boone County,"Boone County, Nebraska",5313,2641,2672
5ea728146307ba36aa1dfbad,31013,05000US31013,Box Butte County,"Box Butte County, Nebraska",11089,5472,5617
5ea728146307ba36aa1dfbae,31015,05000US31015,Boyd County,"Boyd County, Nebraska",2042,1028,1014
5ea728146307ba36aa1dfbaf,31017,05000US31017,Brown County,"Brown County, Nebraska",2988,1430,1558
5ea728146307ba36aa1dfbb0,31019,05000US31019,Buffalo County,"Buffalo County, Nebraska",49030,24593,24437
5ea728146307ba36aa1dfbb1,31021,05000US31021,Burt County,"Burt County, Nebraska",6528,3209,3319
5ea728146307ba36aa1dfbb2,31023,05000US31023,Butler County,"Butler County, Nebraska",8067,4056,4011
5ea728146307ba36aa1dfbb3,31025,05000US31025,Cass County,"Cass County, Nebraska",25702,12929,12773
5ea728146307ba36aa1dfbb4,31027,05000US31027,Cedar County,"Cedar County, Nebraska",8523,4329,4194
5ea728146307ba36aa1dfbb5,31029,05000US31029,Chase County,"Chase County, Nebraska",3734,1865,1869
5ea728146307ba36aa1dfbb6,31031,05000US31031,Cherry County,"Cherry County, Nebraska",5790,2847,2943
5ea728146307ba36aa1dfbb7,31033,05000US31033,Cheyenne County,"Cheyenne County, Nebraska",9852,4903,4949
5ea728146307ba36aa1dfbb8,31035,05000US31035,Clay County,"Clay County, Nebraska",6232,3165,3067
5ea728146307ba36aa1dfbb9,31037,05000US31037,Colfax County,"Colfax County, Nebraska",10760,5870,4890
5ea728146307ba36aa1dfbba,31039,05000US31039,Cuming County,"Cuming County, Nebraska",8991,4505,4486
5ea728146307ba36aa1dfbbb,31041,05000US31041,Custer County,"Custer County, Nebraska",10830,5366,5464
5ea728146307ba36aa1dfbbc,31043,05000US31043,Dakota County,"Dakota County, Nebraska",20317,10219,10098
5ea728146307ba36aa1dfbbd,31045,05000US31045,Dawes County,"Dawes County, Nebraska",8896,4571,4325
5ea728146307ba36aa1dfbbe,31047,05000US31047,Dawson County,"Dawson County, Nebraska",23804,12241,11563
5ea728146307ba36aa1dfbbf,31049,05000US31049,Deuel County,"Deuel County, Nebraska",1894,892,1002
5ea728146307ba36aa1dfbc0,31051,05000US31051,Dixon County,"Dixon County, Nebraska",5746,2884,2862
5ea728146307ba36aa1dfbc1,31053,05000US31053,Dodge County,"Dodge County, Nebraska",36683,18126,18557
5ea728146307ba36aa1dfbc2,31055,05000US31055,Douglas County,"Douglas County, Nebraska",554992,273743,281249
5ea728146307ba36aa1dfbc3,31057,05000US31057,Dundy County,"Dundy County, Nebraska",2023,1013,1010
5ea728146307ba36aa1dfbc4,31059,05000US31059,Fillmore County,"Fillmore County, Nebraska",5574,2782,2792
5ea728146307ba36aa1dfbc5,31061,05000US31061,Franklin County,"Franklin County, Nebraska",3006,1490,1516
5ea728146307ba36aa1dfbc6,31063,05000US31063,Frontier County,"Frontier County, Nebraska",2609,1326,1283
5ea728146307ba36aa1dfbc7,31065,05000US31065,Furnas County,"Furnas County, Nebraska",4786,2349,2437
5ea728146307ba36aa1dfbc8,31067,05000US31067,Gage County,"Gage County, Nebraska",21595,10826,10769
5ea728146307ba36aa1dfbc9,31069,05000US31069,Garden County,"Garden County, Nebraska",1860,937,923
5ea728146307ba36aa1dfbca,31071,05000US31071,Garfield County,"Garfield County, Nebraska",1975,969,1006
5ea728146307ba36aa1dfbcb,31073,05000US31073,Gosper County,"Gosper County, Nebraska",2015,1000,1015
5ea728146307ba36aa1dfbcc,31075,05000US31075,Grant County,"Grant County, Nebraska",718,380,338
5ea728146307ba36aa1dfbcd,31077,05000US31077,Greeley County,"Greeley County, Nebraska",2410,1207,1203
5ea728146307ba36aa1dfbce,31079,05000US31079,Hall County,"Hall County, Nebraska",61343,30830,30513
5ea728146307ba36aa1dfbcf,31081,05000US31081,Hamilton County,"Hamilton County, Nebraska",9178,4564,4614
5ea728146307ba36aa1dfbd0,31083,05000US31083,Harlan County,"Harlan County, Nebraska",3438,1781,1657
5ea728146307ba36aa1dfbd1,31085,05000US31085,Hayes County,"Hayes County, Nebraska",943,495,448
5ea728146307ba36aa1dfbd2,31087,05000US31087,Hitchcock County,"Hitchcock County, Nebraska",2843,1414,1429
5ea728146307ba36aa1dfbd3,31089,05000US31089,Holt County,"Holt County, Nebraska",10245,5142,5103
5ea728146307ba36aa1dfbd4,31091,05000US31091,Hooker County,"Hooker County, Nebraska",691,324,367
5ea728146307ba36aa1dfbd5,31093,05000US31093,Howard County,"Howard County, Nebraska",6405,3227,3178
5ea728146307ba36aa1dfbd6,31095,05000US31095,Jefferson County,"Jefferson County, Nebraska",7188,3486,3702
5ea728146307ba36aa1dfbd7,31097,05000US31097,Johnson County,"Johnson County, Nebraska",5197,3097,2100
5ea728146307ba36aa1dfbd8,31099,05000US31099,Kearney County,"Kearney County, Nebraska",6552,3240,3312
5ea728146307ba36aa1dfbd9,31101,05000US31101,Keith County,"Keith County, Nebraska",8099,4141,3958
5ea728146307ba36aa1dfbda,31103,05000US31103,Keya Paha County,"Keya Paha County, Nebraska",792,416,376
5ea728146307ba36aa1dfbdb,31105,05000US31105,Kimball County,"Kimball County, Nebraska",3667,1855,1812
5ea728146307ba36aa1dfbdc,31107,05000US31107,Knox County,"Knox County, Nebraska",8460,4150,4310
5ea728146307ba36aa1dfbdd,31109,05000US31109,Lancaster County,"Lancaster County, Nebraska",310094,155699,154395
5ea728146307ba36aa1dfbde,31111,05000US31111,Lincoln County,"Lincoln County, Nebraska",35433,17497,17936
5ea728146307ba36aa1dfbdf,31113,05000US31113,Logan County,"Logan County, Nebraska",886,462,424
5ea728146307ba36aa1dfbe0,31115,05000US31115,Loup County,"Loup County, Nebraska",585,291,294
5ea728146307ba36aa1dfbe1,31117,05000US31117,McPherson County,"McPherson County, Nebraska",454,241,213
5ea728146307ba36aa1dfbe2,31119,05000US31119,Madison County,"Madison County, Nebraska",35164,17490,17674
5ea728146307ba36aa1dfbe3,31121,05000US31121,Merrick County,"Merrick County, Nebraska",7803,3919,3884
5ea728146307ba36aa1dfbe4,31123,05000US31123,Morrill County,"Morrill County, Nebraska",4841,2445,2396
5ea728146307ba36aa1dfbe5,31125,05000US31125,Nance County,"Nance County, Nebraska",3554,1769,1785
5ea728146307ba36aa1dfbe6,31127,05000US31127,Nemaha County,"Nemaha County, Nebraska",7004,3465,3539
5ea728146307ba36aa1dfbe7,31129,05000US31129,Nuckolls County,"Nuckolls County, Nebraska",4275,2140,2135
5ea728146307ba36aa1dfbe8,31131,05000US31131,Otoe County,"Otoe County, Nebraska",15896,7742,8154
5ea728146307ba36aa1dfbe9,31133,05000US31133,Pawnee County,"Pawnee County, Nebraska",2676,1277,1399
5ea728146307ba36aa1dfbea,31135,05000US31135,Perkins County,"Perkins County, Nebraska",2907,1499,1408
5ea728146307ba36aa1dfbeb,31137,05000US31137,Phelps County,"Phelps County, Nebraska",9120,4578,4542
5ea728146307ba36aa1dfbec,31139,05000US31139,Pierce County,"Pierce County, Nebraska",7157,3566,3591
5ea728146307ba36aa1dfbed,31141,05000US31141,Platte County,"Platte County, Nebraska",33063,16860,16203
5ea728146307ba36aa1dfbee,31143,05000US31143,Polk County,"Polk County, Nebraska",5255,2540,2715
5ea728146307ba36aa1dfbef,31145,05000US31145,Red Willow County,"Red Willow County, Nebraska",10806,5401,5405
5ea728146307ba36aa1dfbf0,31147,05000US31147,Richardson County,"Richardson County, Nebraska",8009,3974,4035
5ea728146307ba36aa1dfbf1,31149,05000US31149,Rock County,"Rock County, Nebraska",1350,674,676
5ea728146307ba36aa1dfbf2,31151,05000US31151,Saline County,"Saline County, Nebraska",14288,7257,7031
5ea728146307ba36aa1dfbf3,31153,05000US31153,Sarpy County,"Sarpy County, Nebraska",178351,89176,89175
5ea728146307ba36aa1dfbf4,31155,05000US31155,Saunders County,"Saunders County, Nebraska",21024,10628,10396
5ea728146307ba36aa1dfbf5,31157,05000US31157,Scotts Bluff County,"Scotts Bluff County, Nebraska",36255,17575,18680
5ea728146307ba36aa1dfbf6,31159,05000US31159,Seward County,"Seward County, Nebraska",17127,8726,8401
5ea728146307ba36aa1dfbf7,31161,05000US31161,Sheridan County,"Sheridan County, Nebraska",5234,2566,2668
5ea728146307ba36aa1dfbf8,31163,05000US31163,Sherman County,"Sherman County, Nebraska",3042,1527,1515
5ea728146307ba36aa1dfbf9,31165,05000US31165,Sioux County,"Sioux County, Nebraska",1266,643,623
5ea728146307ba36aa1dfbfa,31167,05000US31167,Stanton County,"Stanton County, Nebraska",5992,3002,2990
5ea728146307ba36aa1dfbfb,31169,05000US31169,Thayer County,"Thayer County, Nebraska",5098,2545,2553
5ea728146307ba36aa1dfbfc,31171,05000US31171,Thomas County,"Thomas County, Nebraska",645,321,324
5ea728146307ba36aa1dfbfd,31173,05000US31173,Thurston County,"Thurston County, Nebraska",7140,3545,3595
5ea728146307ba36aa1dfbfe,31175,05000US31175,Valley County,"Valley County, Nebraska",4224,2073,2151
5ea728146307ba36aa1dfbff,31177,05000US31177,Washington County,"Washington County, Nebraska",20219,9911,10308
5ea728146307ba36aa1dfc00,31179,05000US31179,Wayne County,"Wayne County, Nebraska",9367,4716,4651
5ea728146307ba36aa1dfc01,31181,05000US31181,Webster County,"Webster County, Nebraska",3571,1769,1802
5ea728146307ba36aa1dfc02,31183,05000US31183,Wheeler County,"Wheeler County, Nebraska",822,435,387
5ea728146307ba36aa1dfc03,31185,05000US31185,York County,"York County, Nebraska",13799,6693,7106
5ea728146307ba36aa1dfc04,32001,05000US32001,Churchill County,"Churchill County, Nevada",24010,12138,11872
5ea728146307ba36aa1dfc05,32003,05000US32003,Clark County,"Clark County, Nevada",2141574,1069779,1071795
5ea728146307ba36aa1dfc06,32005,05000US32005,Douglas County,"Douglas County, Nevada",47828,24102,23726
5ea728146307ba36aa1dfc07,32007,05000US32007,Elko County,"Elko County, Nevada",52252,27199,25053
5ea728146307ba36aa1dfc08,32009,05000US32009,Esmeralda County,"Esmeralda County, Nevada",981,406,575
5ea728146307ba36aa1dfc09,32011,05000US32011,Eureka County,"Eureka County, Nevada",1830,921,909
5ea728146307ba36aa1dfc0a,32013,05000US32013,Humboldt County,"Humboldt County, Nevada",16904,8779,8125
5ea728146307ba36aa1dfc0b,32015,05000US32015,Lander County,"Lander County, Nevada",5746,3347,2399
5ea728146307ba36aa1dfc0c,32017,05000US32017,Lincoln County,"Lincoln County, Nevada",5174,2673,2501
5ea728146307ba36aa1dfc0d,32019,05000US32019,Lyon County,"Lyon County, Nevada",53155,26757,26398
5ea728146307ba36aa1dfc0e,32021,05000US32021,Mineral County,"Mineral County, Nevada",4448,2205,2243
5ea728146307ba36aa1dfc0f,32023,05000US32023,Nye County,"Nye County, Nevada",43705,22243,21462
5ea728146307ba36aa1dfc10,32027,05000US32027,Pershing County,"Pershing County, Nevada",6611,4286,2325
5ea728146307ba36aa1dfc11,32029,05000US32029,Storey County,"Storey County, Nevada",3941,1963,1978
5ea728146307ba36aa1dfc12,32031,05000US32031,Washoe County,"Washoe County, Nevada",450486,226751,223735
5ea728146307ba36aa1dfc13,32033,05000US32033,White Pine County,"White Pine County, Nevada",9737,5704,4033
5ea728146307ba36aa1dfc14,32510,05000US32510,Carson City,"Carson City, Nevada",54467,27912,26555
5ea728146307ba36aa1dfc15,33001,05000US33001,Belknap County,"Belknap County, New Hampshire",60640,29736,30904
5ea728146307ba36aa1dfc16,33003,05000US33003,Carroll County,"Carroll County, New Hampshire",47840,23845,23995
5ea728146307ba36aa1dfc17,33005,05000US33005,Cheshire County,"Cheshire County, New Hampshire",76263,37221,39042
5ea728146307ba36aa1dfc18,33007,05000US33007,Coos County,"Coos County, New Hampshire",32038,16874,15164
5ea728146307ba36aa1dfc19,33009,05000US33009,Grafton County,"Grafton County, New Hampshire",89811,44161,45650
5ea728146307ba36aa1dfc1a,33011,05000US33011,Hillsborough County,"Hillsborough County, New Hampshire",411087,204293,206794
5ea728146307ba36aa1dfc1b,33013,05000US33013,Merrimack County,"Merrimack County, New Hampshire",149452,73538,75914
5ea728146307ba36aa1dfc1c,33015,05000US33015,Rockingham County,"Rockingham County, New Hampshire",305129,151201,153928
5ea728146307ba36aa1dfc1d,33017,05000US33017,Strafford County,"Strafford County, New Hampshire",128237,62703,65534
5ea728146307ba36aa1dfc1e,33019,05000US33019,Sullivan County,"Sullivan County, New Hampshire",43125,21411,21714
5ea728146307ba36aa1dfc1f,34001,05000US34001,Atlantic County,"Atlantic County, New Jersey",268539,130026,138513
5ea728146307ba36aa1dfc20,34003,05000US34003,Bergen County,"Bergen County, New Jersey",929999,450784,479215
5ea728146307ba36aa1dfc21,34005,05000US34005,Burlington County,"Burlington County, New Jersey",446367,219534,226833
5ea728146307ba36aa1dfc22,34007,05000US34007,Camden County,"Camden County, New Jersey",507367,245068,262299
5ea728146307ba36aa1dfc23,34009,05000US34009,Cape May County,"Cape May County, New Jersey",93705,45829,47876
5ea728146307ba36aa1dfc24,34011,05000US34011,Cumberland County,"Cumberland County, New Jersey",153400,78687,74713
5ea728146307ba36aa1dfc25,34013,05000US34013,Essex County,"Essex County, New Jersey",793555,381576,411979
5ea728146307ba36aa1dfc26,34015,05000US34015,Gloucester County,"Gloucester County, New Jersey",290852,141229,149623
5ea728146307ba36aa1dfc27,34017,05000US34017,Hudson County,"Hudson County, New Jersey",668631,332268,336363
5ea728146307ba36aa1dfc28,34019,05000US34019,Hunterdon County,"Hunterdon County, New Jersey",125051,62447,62604
5ea728146307ba36aa1dfc29,34021,05000US34021,Mercer County,"Mercer County, New Jersey",368762,180369,188393
5ea728146307ba36aa1dfc2a,34023,05000US34023,Middlesex County,"Middlesex County, New Jersey",826698,407247,419451
5ea728146307ba36aa1dfc2b,34025,05000US34025,Monmouth County,"Monmouth County, New Jersey",623387,303154,320233
5ea728146307ba36aa1dfc2c,34027,05000US34027,Morris County,"Morris County, New Jersey",494383,242484,251899
5ea728146307ba36aa1dfc2d,34029,05000US34029,Ocean County,"Ocean County, New Jersey",591939,285371,306568
5ea728146307ba36aa1dfc2e,34031,05000US34031,Passaic County,"Passaic County, New Jersey",504041,245463,258578
5ea728146307ba36aa1dfc2f,34033,05000US34033,Salem County,"Salem County, New Jersey",63336,30982,32354
5ea728146307ba36aa1dfc30,34035,05000US34035,Somerset County,"Somerset County, New Jersey",330176,161296,168880
5ea728146307ba36aa1dfc31,34037,05000US34037,Sussex County,"Sussex County, New Jersey",142298,70730,71568
5ea728146307ba36aa1dfc32,34039,05000US34039,Union County,"Union County, New Jersey",553066,269450,283616
5ea728146307ba36aa1dfc33,34041,05000US34041,Warren County,"Warren County, New Jersey",106293,51936,54357
5ea728146307ba36aa1dfc34,35001,05000US35001,Bernalillo County,"Bernalillo County, New Mexico",677692,332271,345421
5ea728146307ba36aa1dfc35,35003,05000US35003,Catron County,"Catron County, New Mexico",3539,1930,1609
5ea728146307ba36aa1dfc36,35005,05000US35005,Chaves County,"Chaves County, New Mexico",65459,32600,32859
5ea728146307ba36aa1dfc37,35006,05000US35006,Cibola County,"Cibola County, New Mexico",26978,13648,13330
5ea728146307ba36aa1dfc38,35007,05000US35007,Colfax County,"Colfax County, New Mexico",12353,6309,6044
5ea728146307ba36aa1dfc39,35009,05000US35009,Curry County,"Curry County, New Mexico",50199,26109,24090
5ea728146307ba36aa1dfc3a,35011,05000US35011,De Baca County,"De Baca County, New Mexico",2060,1052,1008
5ea728146307ba36aa1dfc3b,35013,05000US35013,Do�a Ana County,"Do�a Ana County, New Mexico",215338,105774,109564
5ea728146307ba36aa1dfc3c,35015,05000US35015,Eddy County,"Eddy County, New Mexico",57437,28989,28448
5ea728146307ba36aa1dfc3d,35017,05000US35017,Grant County,"Grant County, New Mexico",28061,13869,14192
5ea728146307ba36aa1dfc3e,35019,05000US35019,Guadalupe County,"Guadalupe County, New Mexico",4382,2507,1875
5ea728146307ba36aa1dfc3f,35021,05000US35021,Harding County,"Harding County, New Mexico",459,266,193
5ea728146307ba36aa1dfc40,35023,05000US35023,Hidalgo County,"Hidalgo County, New Mexico",4371,2149,2222
5ea728146307ba36aa1dfc41,35025,05000US35025,Lea County,"Lea County, New Mexico",70126,36137,33989
5ea728146307ba36aa1dfc42,35027,05000US35027,Lincoln County,"Lincoln County, New Mexico",19482,9228,10254
5ea728146307ba36aa1dfc43,35028,05000US35028,Los Alamos County,"Los Alamos County, New Mexico",18356,9353,9003
5ea728146307ba36aa1dfc44,35029,05000US35029,Luna County,"Luna County, New Mexico",24264,12020,12244
5ea728146307ba36aa1dfc45,35031,05000US35031,McKinley County,"McKinley County, New Mexico",72849,35158,37691
5ea728146307ba36aa1dfc46,35033,05000US35033,Mora County,"Mora County, New Mexico",4563,2230,2333
5ea728146307ba36aa1dfc47,35035,05000US35035,Otero County,"Otero County, New Mexico",65745,33886,31859
5ea728146307ba36aa1dfc48,35037,05000US35037,Quay County,"Quay County, New Mexico",8373,3881,4492
5ea728146307ba36aa1dfc49,35039,05000US35039,Rio Arriba County,"Rio Arriba County, New Mexico",39307,19250,20057
5ea728146307ba36aa1dfc4a,35041,05000US35041,Roosevelt County,"Roosevelt County, New Mexico",19117,9523,9594
5ea728146307ba36aa1dfc4b,35043,05000US35043,Sandoval County,"Sandoval County, New Mexico",140769,68955,71814
5ea728146307ba36aa1dfc4c,35045,05000US35045,San Juan County,"San Juan County, New Mexico",127455,63123,64332
5ea728146307ba36aa1dfc4d,35047,05000US35047,San Miguel County,"San Miguel County, New Mexico",28034,14108,13926
5ea728146307ba36aa1dfc4e,35049,05000US35049,Santa Fe County,"Santa Fe County, New Mexico",148917,72344,76573
5ea728146307ba36aa1dfc4f,35051,05000US35051,Sierra County,"Sierra County, New Mexico",11135,5516,5619
5ea728146307ba36aa1dfc50,35053,05000US35053,Socorro County,"Socorro County, New Mexico",17000,8799,8201
5ea728146307ba36aa1dfc51,35055,05000US35055,Taos County,"Taos County, New Mexico",32888,16076,16812
5ea728146307ba36aa1dfc52,35057,05000US35057,Torrance County,"Torrance County, New Mexico",15595,8358,7237
5ea728146307ba36aa1dfc53,35059,05000US35059,Union County,"Union County, New Mexico",4175,2302,1873
5ea728146307ba36aa1dfc54,35061,05000US35061,Valencia County,"Valencia County, New Mexico",75956,38130,37826
5ea728146307ba36aa1dfc55,36001,05000US36001,Albany County,"Albany County, New York",307426,148910,158516
5ea728146307ba36aa1dfc56,36003,05000US36003,Allegany County,"Allegany County, New York",47025,23755,23270
5ea728146307ba36aa1dfc57,36005,05000US36005,Bronx County,"Bronx County, New York",1437872,676963,760909
5ea728146307ba36aa1dfc58,36007,05000US36007,Broome County,"Broome County, New York",194402,95608,98794
5ea728146307ba36aa1dfc59,36009,05000US36009,Cattaraugus County,"Cattaraugus County, New York",77686,38491,39195
5ea728146307ba36aa1dfc5a,36011,05000US36011,Cayuga County,"Cayuga County, New York",77868,39982,37886
5ea728146307ba36aa1dfc5b,36013,05000US36013,Chautauqua County,"Chautauqua County, New York",129656,63960,65696
5ea728146307ba36aa1dfc5c,36015,05000US36015,Chemung County,"Chemung County, New York",85740,42556,43184
5ea728146307ba36aa1dfc5d,36017,05000US36017,Chenango County,"Chenango County, New York",48348,24227,24121
5ea728146307ba36aa1dfc5e,36019,05000US36019,Clinton County,"Clinton County, New York",80794,41499,39295
5ea728146307ba36aa1dfc5f,36021,05000US36021,Columbia County,"Columbia County, New York",60919,30495,30424
5ea728146307ba36aa1dfc60,36023,05000US36023,Cortland County,"Cortland County, New York",48123,23550,24573
5ea728146307ba36aa1dfc61,36025,05000US36025,Delaware County,"Delaware County, New York",45502,22943,22559
5ea728146307ba36aa1dfc62,36027,05000US36027,Dutchess County,"Dutchess County, New York",293894,146174,147720
5ea728146307ba36aa1dfc63,36029,05000US36029,Erie County,"Erie County, New York",919866,444998,474868
5ea728146307ba36aa1dfc64,36031,05000US36031,Essex County,"Essex County, New York",37751,19622,18129
5ea728146307ba36aa1dfc65,36033,05000US36033,Franklin County,"Franklin County, New York",50692,27816,22876
5ea728146307ba36aa1dfc66,36035,05000US36035,Fulton County,"Fulton County, New York",53743,26847,26896
5ea728146307ba36aa1dfc67,36037,05000US36037,Genesee County,"Genesee County, New York",58112,29022,29090
5ea728146307ba36aa1dfc68,36039,05000US36039,Greene County,"Greene County, New York",47617,24903,22714
5ea728146307ba36aa1dfc69,36041,05000US36041,Hamilton County,"Hamilton County, New York",4575,2347,2228
5ea728146307ba36aa1dfc6a,36043,05000US36043,Herkimer County,"Herkimer County, New York",62505,30918,31587
5ea728146307ba36aa1dfc6b,36045,05000US36045,Jefferson County,"Jefferson County, New York",114448,59931,54517
5ea728146307ba36aa1dfc6c,36047,05000US36047,Kings County,"Kings County, New York",2600747,1231912,1368835
5ea728146307ba36aa1dfc6d,36049,05000US36049,Lewis County,"Lewis County, New York",26719,13451,13268
5ea728146307ba36aa1dfc6e,36051,05000US36051,Livingston County,"Livingston County, New York",63907,32050,31857
5ea728146307ba36aa1dfc6f,36053,05000US36053,Madison County,"Madison County, New York",71359,35252,36107
5ea728146307ba36aa1dfc70,36055,05000US36055,Monroe County,"Monroe County, New York",744248,359374,384874
5ea728146307ba36aa1dfc71,36057,05000US36057,Montgomery County,"Montgomery County, New York",49426,24265,25161
5ea728146307ba36aa1dfc72,36059,05000US36059,Nassau County,"Nassau County, New York",1356564,659405,697159
5ea728146307ba36aa1dfc73,36061,05000US36061,New York County,"New York County, New York",1632480,772144,860336
5ea728146307ba36aa1dfc74,36063,05000US36063,Niagara County,"Niagara County, New York",211704,103127,108577
5ea728146307ba36aa1dfc75,36065,05000US36065,Oneida County,"Oneida County, New York",230782,115089,115693
5ea728146307ba36aa1dfc76,36067,05000US36067,Onondaga County,"Onondaga County, New York",464242,223995,240247
5ea728146307ba36aa1dfc77,36069,05000US36069,Ontario County,"Ontario County, New York",109472,53704,55768
5ea728146307ba36aa1dfc78,36071,05000US36071,Orange County,"Orange County, New York",378227,189484,188743
5ea728146307ba36aa1dfc79,36073,05000US36073,Orleans County,"Orleans County, New York",41175,20539,20636
5ea728146307ba36aa1dfc7a,36075,05000US36075,Oswego County,"Oswego County, New York",119104,59648,59456
5ea728146307ba36aa1dfc7b,36077,05000US36077,Otsego County,"Otsego County, New York",60244,29127,31117
5ea728146307ba36aa1dfc7c,36079,05000US36079,Putnam County,"Putnam County, New York",99070,49296,49774
5ea728146307ba36aa1dfc7d,36081,05000US36081,Queens County,"Queens County, New York",2298513,1114654,1183859
5ea728146307ba36aa1dfc7e,36083,05000US36083,Rensselaer County,"Rensselaer County, New York",159431,78611,80820
5ea728146307ba36aa1dfc7f,36085,05000US36085,Richmond County,"Richmond County, New York",474101,229424,244677
5ea728146307ba36aa1dfc80,36087,05000US36087,Rockland County,"Rockland County, New York",323686,158667,165019
5ea728146307ba36aa1dfc81,36089,05000US36089,St. Lawrence County,"St. Lawrence County, New York",109558,55780,53778
5ea728146307ba36aa1dfc82,36091,05000US36091,Saratoga County,"Saratoga County, New York",227377,112468,114909
5ea728146307ba36aa1dfc83,36093,05000US36093,Schenectady County,"Schenectady County, New York",154883,75453,79430
5ea728146307ba36aa1dfc84,36095,05000US36095,Schoharie County,"Schoharie County, New York",31364,15620,15744
5ea728146307ba36aa1dfc85,36097,05000US36097,Schuyler County,"Schuyler County, New York",17992,8979,9013
5ea728146307ba36aa1dfc86,36099,05000US36099,Seneca County,"Seneca County, New York",34612,18096,16516
5ea728146307ba36aa1dfc87,36101,05000US36101,Steuben County,"Steuben County, New York",96927,48397,48530
5ea728146307ba36aa1dfc88,36103,05000US36103,Suffolk County,"Suffolk County, New York",1487901,732269,755632
5ea728146307ba36aa1dfc89,36105,05000US36105,Sullivan County,"Sullivan County, New York",75211,38595,36616
5ea728146307ba36aa1dfc8a,36107,05000US36107,Tioga County,"Tioga County, New York",49045,24264,24781
5ea728146307ba36aa1dfc8b,36109,05000US36109,Tompkins County,"Tompkins County, New York",102962,50823,52139
5ea728146307ba36aa1dfc8c,36111,05000US36111,Ulster County,"Ulster County, New York",179303,88774,90529
5ea728146307ba36aa1dfc8d,36113,05000US36113,Warren County,"Warren County, New York",64480,31698,32782
5ea728146307ba36aa1dfc8e,36115,05000US36115,Washington County,"Washington County, New York",61828,32002,29826
5ea728146307ba36aa1dfc8f,36117,05000US36117,Wayne County,"Wayne County, New York",90856,44971,45885
5ea728146307ba36aa1dfc90,36119,05000US36119,Westchester County,"Westchester County, New York",968815,468898,499917
5ea728146307ba36aa1dfc91,36121,05000US36121,Wyoming County,"Wyoming County, New York",40565,21734,18831
5ea728146307ba36aa1dfc92,36123,05000US36123,Yates County,"Yates County, New York",25009,11999,13010
5ea728146307ba36aa1dfc93,37001,05000US37001,Alamance County,"Alamance County, North Carolina",160576,76259,84317
5ea728146307ba36aa1dfc94,37003,05000US37003,Alexander County,"Alexander County, North Carolina",37119,18942,18177
5ea728146307ba36aa1dfc95,37005,05000US37005,Alleghany County,"Alleghany County, North Carolina",10973,5386,5587
5ea728146307ba36aa1dfc96,37007,05000US37007,Anson County,"Anson County, North Carolina",25306,13285,12021
5ea728146307ba36aa1dfc97,37009,05000US37009,Ashe County,"Ashe County, North Carolina",26786,13168,13618
5ea728146307ba36aa1dfc98,37011,05000US37011,Avery County,"Avery County, North Carolina",17501,9488,8013
5ea728146307ba36aa1dfc99,37013,05000US37013,Beaufort County,"Beaufort County, North Carolina",47243,22709,24534
5ea728146307ba36aa1dfc9a,37015,05000US37015,Bertie County,"Bertie County, North Carolina",19644,9895,9749
5ea728146307ba36aa1dfc9b,37017,05000US37017,Bladen County,"Bladen County, North Carolina",33778,16054,17724
5ea728146307ba36aa1dfc9c,37019,05000US37019,Brunswick County,"Brunswick County, North Carolina",126860,61281,65579
5ea728146307ba36aa1dfc9d,37021,05000US37021,Buncombe County,"Buncombe County, North Carolina",254474,122297,132177
5ea728146307ba36aa1dfc9e,37023,05000US37023,Burke County,"Burke County, North Carolina",89712,44798,44914
5ea728146307ba36aa1dfc9f,37025,05000US37025,Cabarrus County,"Cabarrus County, North Carolina",201448,98094,103354
5ea728146307ba36aa1dfca0,37027,05000US37027,Caldwell County,"Caldwell County, North Carolina",81779,40354,41425
5ea728146307ba36aa1dfca1,37029,05000US37029,Camden County,"Camden County, North Carolina",10447,5263,5184
5ea728146307ba36aa1dfca2,37031,05000US37031,Carteret County,"Carteret County, North Carolina",68920,33839,35081
5ea728146307ba36aa1dfca3,37033,05000US37033,Caswell County,"Caswell County, North Carolina",22746,11393,11353
5ea728146307ba36aa1dfca4,37035,05000US37035,Catawba County,"Catawba County, North Carolina",156729,76703,80026
5ea728146307ba36aa1dfca5,37037,05000US37037,Chatham County,"Chatham County, North Carolina",69791,33477,36314
5ea728146307ba36aa1dfca6,37039,05000US37039,Cherokee County,"Cherokee County, North Carolina",27668,13583,14085
5ea728146307ba36aa1dfca7,37041,05000US37041,Chowan County,"Chowan County, North Carolina",14205,6653,7552
5ea728146307ba36aa1dfca8,37043,05000US37043,Clay County,"Clay County, North Carolina",10813,5125,5688
5ea728146307ba36aa1dfca9,37045,05000US37045,Cleveland County,"Cleveland County, North Carolina",97159,46856,50303
5ea728146307ba36aa1dfcaa,37047,05000US37047,Columbus County,"Columbus County, North Carolina",56293,27981,28312
5ea728146307ba36aa1dfcab,37049,05000US37049,Craven County,"Craven County, North Carolina",103082,52246,50836
5ea728146307ba36aa1dfcac,37051,05000US37051,Cumberland County,"Cumberland County, North Carolina",332106,165152,166954
5ea728146307ba36aa1dfcad,37053,05000US37053,Currituck County,"Currituck County, North Carolina",25796,12822,12974
5ea728146307ba36aa1dfcae,37055,05000US37055,Dare County,"Dare County, North Carolina",35741,17614,18127
5ea728146307ba36aa1dfcaf,37057,05000US37057,Davidson County,"Davidson County, North Carolina",164664,80508,84156
5ea728146307ba36aa1dfcb0,37059,05000US37059,Davie County,"Davie County, North Carolina",41991,20374,21617
5ea728146307ba36aa1dfcb1,37061,05000US37061,Duplin County,"Duplin County, North Carolina",59062,28780,30282
5ea728146307ba36aa1dfcb2,37063,05000US37063,Durham County,"Durham County, North Carolina",306457,146535,159922
5ea728146307ba36aa1dfcb3,37065,05000US37065,Edgecombe County,"Edgecombe County, North Carolina",53332,24856,28476
5ea728146307ba36aa1dfcb4,37067,05000US37067,Forsyth County,"Forsyth County, North Carolina",371573,176337,195236
5ea728146307ba36aa1dfcb5,37069,05000US37069,Franklin County,"Franklin County, North Carolina",64902,32281,32621
5ea728146307ba36aa1dfcb6,37071,05000US37071,Gaston County,"Gaston County, North Carolina",216585,104371,112214
5ea728146307ba36aa1dfcb7,37073,05000US37073,Gates County,"Gates County, North Carolina",11563,5627,5936
5ea728146307ba36aa1dfcb8,37075,05000US37075,Graham County,"Graham County, North Carolina",8557,4210,4347
5ea728146307ba36aa1dfcb9,37077,05000US37077,Granville County,"Granville County, North Carolina",58874,30046,28828
5ea728146307ba36aa1dfcba,37079,05000US37079,Greene County,"Greene County, North Carolina",21008,11593,9415
5ea728146307ba36aa1dfcbb,37081,05000US37081,Guilford County,"Guilford County, North Carolina",523582,248019,275563
5ea728146307ba36aa1dfcbc,37083,05000US37083,Halifax County,"Halifax County, North Carolina",51737,24959,26778
5ea728146307ba36aa1dfcbd,37085,05000US37085,Harnett County,"Harnett County, North Carolina",130361,64574,65787
5ea728146307ba36aa1dfcbe,37087,05000US37087,Haywood County,"Haywood County, North Carolina",60433,29220,31213
5ea728146307ba36aa1dfcbf,37089,05000US37089,Henderson County,"Henderson County, North Carolina",113625,54724,58901
5ea728146307ba36aa1dfcc0,37091,05000US37091,Hertford County,"Hertford County, North Carolina",24153,11947,12206
5ea728146307ba36aa1dfcc1,37093,05000US37093,Hoke County,"Hoke County, North Carolina",53239,26320,26919
5ea728146307ba36aa1dfcc2,37095,05000US37095,Hyde County,"Hyde County, North Carolina",5393,2832,2561
5ea728146307ba36aa1dfcc3,37097,05000US37097,Iredell County,"Iredell County, North Carolina",172525,84936,87589
5ea728146307ba36aa1dfcc4,37099,05000US37099,Jackson County,"Jackson County, North Carolina",42256,20838,21418
5ea728146307ba36aa1dfcc5,37101,05000US37101,Johnston County,"Johnston County, North Carolina",191172,93865,97307
5ea728146307ba36aa1dfcc6,37103,05000US37103,Jones County,"Jones County, North Carolina",9695,4828,4867
5ea728146307ba36aa1dfcc7,37105,05000US37105,Lee County,"Lee County, North Carolina",60125,29225,30900
5ea728146307ba36aa1dfcc8,37107,05000US37107,Lenoir County,"Lenoir County, North Carolina",57227,27391,29836
5ea728146307ba36aa1dfcc9,37109,05000US37109,Lincoln County,"Lincoln County, North Carolina",81441,40372,41069
5ea728146307ba36aa1dfcca,37111,05000US37111,McDowell County,"McDowell County, North Carolina",45109,22833,22276
5ea728146307ba36aa1dfccb,37113,05000US37113,Macon County,"Macon County, North Carolina",34410,16630,17780
5ea728146307ba36aa1dfccc,37115,05000US37115,Madison County,"Madison County, North Carolina",21405,10502,10903
5ea728146307ba36aa1dfccd,37117,05000US37117,Martin County,"Martin County, North Carolina",23054,10805,12249
5ea728146307ba36aa1dfcce,37119,05000US37119,Mecklenburg County,"Mecklenburg County, North Carolina",1054314,506721,547593
5ea728146307ba36aa1dfccf,37121,05000US37121,Mitchell County,"Mitchell County, North Carolina",15040,7400,7640
5ea728146307ba36aa1dfcd0,37123,05000US37123,Montgomery County,"Montgomery County, North Carolina",27338,13546,13792
5ea728146307ba36aa1dfcd1,37125,05000US37125,Moore County,"Moore County, North Carolina",95629,46002,49627
5ea728146307ba36aa1dfcd2,37127,05000US37127,Nash County,"Nash County, North Carolina",94003,45125,48878
5ea728146307ba36aa1dfcd3,37129,05000US37129,New Hanover County,"New Hanover County, North Carolina",224231,107274,116957
5ea728146307ba36aa1dfcd4,37131,05000US37131,Northampton County,"Northampton County, North Carolina",20186,9845,10341
5ea728146307ba36aa1dfcd5,37133,05000US37133,Onslow County,"Onslow County, North Carolina",193912,107681,86231
5ea728146307ba36aa1dfcd6,37135,05000US37135,Orange County,"Orange County, North Carolina",142938,68187,74751
5ea728146307ba36aa1dfcd7,37137,05000US37137,Pamlico County,"Pamlico County, North Carolina",12742,6563,6179
5ea728146307ba36aa1dfcd8,37139,05000US37139,Pasquotank County,"Pasquotank County, North Carolina",39479,19146,20333
5ea728146307ba36aa1dfcd9,37141,05000US37141,Pender County,"Pender County, North Carolina",59020,29239,29781
5ea728146307ba36aa1dfcda,37143,05000US37143,Perquimans County,"Perquimans County, North Carolina",13459,6493,6966
5ea728146307ba36aa1dfcdb,37145,05000US37145,Person County,"Person County, North Carolina",39305,18989,20316
5ea728146307ba36aa1dfcdc,37147,05000US37147,Pitt County,"Pitt County, North Carolina",177372,83620,93752
5ea728146307ba36aa1dfcdd,37149,05000US37149,Polk County,"Polk County, North Carolina",20458,9682,10776
5ea728146307ba36aa1dfcde,37151,05000US37151,Randolph County,"Randolph County, North Carolina",142958,70428,72530
5ea728146307ba36aa1dfcdf,37153,05000US37153,Richmond County,"Richmond County, North Carolina",45189,22124,23065
5ea728146307ba36aa1dfce0,37155,05000US37155,Robeson County,"Robeson County, North Carolina",133442,64365,69077
5ea728146307ba36aa1dfce1,37157,05000US37157,Rockingham County,"Rockingham County, North Carolina",91270,43989,47281
5ea728146307ba36aa1dfce2,37159,05000US37159,Rowan County,"Rowan County, North Carolina",139605,69165,70440
5ea728146307ba36aa1dfce3,37161,05000US37161,Rutherford County,"Rutherford County, North Carolina",66532,32258,34274
5ea728146307ba36aa1dfce4,37163,05000US37163,Sampson County,"Sampson County, North Carolina",63561,31231,32330
5ea728146307ba36aa1dfce5,37165,05000US37165,Scotland County,"Scotland County, North Carolina",35262,17398,17864
5ea728146307ba36aa1dfce6,37167,05000US37167,Stanly County,"Stanly County, North Carolina",61114,30445,30669
5ea728146307ba36aa1dfce7,37169,05000US37169,Stokes County,"Stokes County, North Carolina",45905,22483,23422
5ea728146307ba36aa1dfce8,37171,05000US37171,Surry County,"Surry County, North Carolina",72099,34858,37241
5ea728146307ba36aa1dfce9,37173,05000US37173,Swain County,"Swain County, North Carolina",14254,6799,7455
5ea728146307ba36aa1dfcea,37175,05000US37175,Transylvania County,"Transylvania County, North Carolina",33513,16045,17468
5ea728146307ba36aa1dfceb,37177,05000US37177,Tyrrell County,"Tyrrell County, North Carolina",4119,2365,1754
5ea728146307ba36aa1dfcec,37179,05000US37179,Union County,"Union County, North Carolina",226694,111658,115036
5ea728146307ba36aa1dfced,37181,05000US37181,Vance County,"Vance County, North Carolina",44482,20823,23659
5ea728146307ba36aa1dfcee,37183,05000US37183,Wake County,"Wake County, North Carolina",1046558,508866,537692
5ea728146307ba36aa1dfcef,37185,05000US37185,Warren County,"Warren County, North Carolina",20033,9985,10048
5ea728146307ba36aa1dfcf0,37187,05000US37187,Washington County,"Washington County, North Carolina",12156,5726,6430
5ea728146307ba36aa1dfcf1,37189,05000US37189,Watauga County,"Watauga County, North Carolina",54117,27145,26972
5ea728146307ba36aa1dfcf2,37191,05000US37191,Wayne County,"Wayne County, North Carolina",124002,60640,63362
5ea728146307ba36aa1dfcf3,37193,05000US37193,Wilkes County,"Wilkes County, North Carolina",68460,33719,34741
5ea728146307ba36aa1dfcf4,37195,05000US37195,Wilson County,"Wilson County, North Carolina",81336,38362,42974
5ea728146307ba36aa1dfcf5,37197,05000US37197,Yadkin County,"Yadkin County, North Carolina",37665,18666,18999
5ea728146307ba36aa1dfcf6,37199,05000US37199,Yancey County,"Yancey County, North Carolina",17667,8648,9019
5ea728146307ba36aa1dfcf7,38001,05000US38001,Adams County,"Adams County, North Dakota",2351,1115,1236
5ea728146307ba36aa1dfcf8,38003,05000US38003,Barnes County,"Barnes County, North Dakota",10836,5430,5406
5ea728146307ba36aa1dfcf9,38005,05000US38005,Benson County,"Benson County, North Dakota",6886,3529,3357
5ea728146307ba36aa1dfcfa,38007,05000US38007,Billings County,"Billings County, North Dakota",946,556,390
5ea728146307ba36aa1dfcfb,38009,05000US38009,Bottineau County,"Bottineau County, North Dakota",6589,3457,3132
5ea728146307ba36aa1dfcfc,38011,05000US38011,Bowman County,"Bowman County, North Dakota",3195,1590,1605
5ea728146307ba36aa1dfcfd,38013,05000US38013,Burke County,"Burke County, North Dakota",2213,1183,1030
5ea728146307ba36aa1dfcfe,38015,05000US38015,Burleigh County,"Burleigh County, North Dakota",93737,47152,46585
5ea728146307ba36aa1dfcff,38017,05000US38017,Cass County,"Cass County, North Dakota",174202,88346,85856
5ea728146307ba36aa1dfd00,38019,05000US38019,Cavalier County,"Cavalier County, North Dakota",3824,1959,1865
5ea728146307ba36aa1dfd01,38021,05000US38021,Dickey County,"Dickey County, North Dakota",4970,2450,2520
5ea728146307ba36aa1dfd02,38023,05000US38023,Divide County,"Divide County, North Dakota",2369,1174,1195
5ea728146307ba36aa1dfd03,38025,05000US38025,Dunn County,"Dunn County, North Dakota",4387,2298,2089
5ea728146307ba36aa1dfd04,38027,05000US38027,Eddy County,"Eddy County, North Dakota",2313,1085,1228
5ea728146307ba36aa1dfd05,38029,05000US38029,Emmons County,"Emmons County, North Dakota",3352,1704,1648
5ea728146307ba36aa1dfd06,38031,05000US38031,Foster County,"Foster County, North Dakota",3290,1616,1674
5ea728146307ba36aa1dfd07,38033,05000US38033,Golden Valley County,"Golden Valley County, North Dakota",1882,892,990
5ea728146307ba36aa1dfd08,38035,05000US38035,Grand Forks County,"Grand Forks County, North Dakota",70400,36536,33864
5ea728146307ba36aa1dfd09,38037,05000US38037,Grant County,"Grant County, North Dakota",2380,1205,1175
5ea728146307ba36aa1dfd0a,38039,05000US38039,Griggs County,"Griggs County, North Dakota",2266,1142,1124
5ea728146307ba36aa1dfd0b,38041,05000US38041,Hettinger County,"Hettinger County, North Dakota",2576,1250,1326
5ea728146307ba36aa1dfd0c,38043,05000US38043,Kidder County,"Kidder County, North Dakota",2460,1301,1159
5ea728146307ba36aa1dfd0d,38045,05000US38045,LaMoure County,"LaMoure County, North Dakota",4100,2148,1952
5ea728146307ba36aa1dfd0e,38047,05000US38047,Logan County,"Logan County, North Dakota",1927,1000,927
5ea728146307ba36aa1dfd0f,38049,05000US38049,McHenry County,"McHenry County, North Dakota",5927,3034,2893
5ea728146307ba36aa1dfd10,38051,05000US38051,McIntosh County,"McIntosh County, North Dakota",2654,1323,1331
5ea728146307ba36aa1dfd11,38053,05000US38053,McKenzie County,"McKenzie County, North Dakota",12536,6822,5714
5ea728146307ba36aa1dfd12,38055,05000US38055,McLean County,"McLean County, North Dakota",9608,4958,4650
5ea728146307ba36aa1dfd13,38057,05000US38057,Mercer County,"Mercer County, North Dakota",8570,4406,4164
5ea728146307ba36aa1dfd14,38059,05000US38059,Morton County,"Morton County, North Dakota",30544,15753,14791
5ea728146307ba36aa1dfd15,38061,05000US38061,Mountrail County,"Mountrail County, North Dakota",10152,5489,4663
5ea728146307ba36aa1dfd16,38063,05000US38063,Nelson County,"Nelson County, North Dakota",2920,1485,1435
5ea728146307ba36aa1dfd17,38065,05000US38065,Oliver County,"Oliver County, North Dakota",1837,935,902
5ea728146307ba36aa1dfd18,38067,05000US38067,Pembina County,"Pembina County, North Dakota",7016,3649,3367
5ea728146307ba36aa1dfd19,38069,05000US38069,Pierce County,"Pierce County, North Dakota",4210,2115,2095
5ea728146307ba36aa1dfd1a,38071,05000US38071,Ramsey County,"Ramsey County, North Dakota",11557,5886,5671
5ea728146307ba36aa1dfd1b,38073,05000US38073,Ransom County,"Ransom County, North Dakota",5361,2677,2684
5ea728146307ba36aa1dfd1c,38075,05000US38075,Renville County,"Renville County, North Dakota",2495,1258,1237
5ea728146307ba36aa1dfd1d,38077,05000US38077,Richland County,"Richland County, North Dakota",16288,8528,7760
5ea728146307ba36aa1dfd1e,38079,05000US38079,Rolette County,"Rolette County, North Dakota",14603,7218,7385
5ea728146307ba36aa1dfd1f,38081,05000US38081,Sargent County,"Sargent County, North Dakota",3883,2052,1831
5ea728146307ba36aa1dfd20,38083,05000US38083,Sheridan County,"Sheridan County, North Dakota",1405,723,682
5ea728146307ba36aa1dfd21,38085,05000US38085,Sioux County,"Sioux County, North Dakota",4413,2209,2204
5ea728146307ba36aa1dfd22,38087,05000US38087,Slope County,"Slope County, North Dakota",704,353,351
5ea728146307ba36aa1dfd23,38089,05000US38089,Stark County,"Stark County, North Dakota",30876,15864,15012
5ea728146307ba36aa1dfd24,38091,05000US38091,Steele County,"Steele County, North Dakota",1910,1001,909
5ea728146307ba36aa1dfd25,38093,05000US38093,Stutsman County,"Stutsman County, North Dakota",21064,10875,10189
5ea728146307ba36aa1dfd26,38095,05000US38095,Towner County,"Towner County, North Dakota",2246,1197,1049
5ea728146307ba36aa1dfd27,38097,05000US38097,Traill County,"Traill County, North Dakota",8019,4077,3942
5ea728146307ba36aa1dfd28,38099,05000US38099,Walsh County,"Walsh County, North Dakota",10802,5543,5259
5ea728146307ba36aa1dfd29,38101,05000US38101,Ward County,"Ward County, North Dakota",69034,35881,33153
5ea728146307ba36aa1dfd2a,38103,05000US38103,Wells County,"Wells County, North Dakota",4055,2003,2052
5ea728146307ba36aa1dfd2b,38105,05000US38105,Williams County,"Williams County, North Dakota",34061,18751,15310
5ea728146307ba36aa1dfd2c,39001,05000US39001,Adams County,"Adams County, Ohio",27878,13950,13928
5ea728146307ba36aa1dfd2d,39003,05000US39003,Allen County,"Allen County, Ohio",103642,52371,51271
5ea728146307ba36aa1dfd2e,39005,05000US39005,Ashland County,"Ashland County, Ohio",53477,26101,27376
5ea728146307ba36aa1dfd2f,39007,05000US39007,Ashtabula County,"Ashtabula County, Ohio",98136,49335,48801
5ea728146307ba36aa1dfd30,39009,05000US39009,Athens County,"Athens County, Ohio",65936,32846,33090
5ea728146307ba36aa1dfd31,39011,05000US39011,Auglaize County,"Auglaize County, Ohio",45784,22705,23079
5ea728146307ba36aa1dfd32,39013,05000US39013,Belmont County,"Belmont County, Ohio",68472,34995,33477
5ea728146307ba36aa1dfd33,39015,05000US39015,Brown County,"Brown County, Ohio",43679,21649,22030
5ea728146307ba36aa1dfd34,39017,05000US39017,Butler County,"Butler County, Ohio",378294,185536,192758
5ea728146307ba36aa1dfd35,39019,05000US39019,Carroll County,"Carroll County, Ohio",27578,13752,13826
5ea728146307ba36aa1dfd36,39021,05000US39021,Champaign County,"Champaign County, Ohio",38864,19366,19498
5ea728146307ba36aa1dfd37,39023,05000US39023,Clark County,"Clark County, Ohio",135198,65405,69793
5ea728146307ba36aa1dfd38,39025,05000US39025,Clermont County,"Clermont County, Ohio",203216,100124,103092
5ea728146307ba36aa1dfd39,39027,05000US39027,Clinton County,"Clinton County, Ohio",41896,20769,21127
5ea728146307ba36aa1dfd3a,39029,05000US39029,Columbiana County,"Columbiana County, Ohio",104003,52418,51585
5ea728146307ba36aa1dfd3b,39031,05000US39031,Coshocton County,"Coshocton County, Ohio",36574,18108,18466
5ea728146307ba36aa1dfd3c,39033,05000US39033,Crawford County,"Crawford County, Ohio",42021,20612,21409
5ea728146307ba36aa1dfd3d,39035,05000US39035,Cuyahoga County,"Cuyahoga County, Ohio",1253783,597647,656136
5ea728146307ba36aa1dfd3e,39037,05000US39037,Darke County,"Darke County, Ohio",51734,25557,26177
5ea728146307ba36aa1dfd3f,39039,05000US39039,Defiance County,"Defiance County, Ohio",38279,19019,19260
5ea728146307ba36aa1dfd40,39041,05000US39041,Delaware County,"Delaware County, Ohio",197008,97504,99504
5ea728146307ba36aa1dfd41,39043,05000US39043,Erie County,"Erie County, Ohio",75136,36863,38273
5ea728146307ba36aa1dfd42,39045,05000US39045,Fairfield County,"Fairfield County, Ohio",152910,76254,76656
5ea728146307ba36aa1dfd43,39047,05000US39047,Fayette County,"Fayette County, Ohio",28645,13960,14685
5ea728146307ba36aa1dfd44,39049,05000US39049,Franklin County,"Franklin County, Ohio",1275333,622353,652980
5ea728146307ba36aa1dfd45,39051,05000US39051,Fulton County,"Fulton County, Ohio",42305,20940,21365
5ea728146307ba36aa1dfd46,39053,05000US39053,Gallia County,"Gallia County, Ohio",30195,14802,15393
5ea728146307ba36aa1dfd47,39055,05000US39055,Geauga County,"Geauga County, Ohio",93961,46425,47536
5ea728146307ba36aa1dfd48,39057,05000US39057,Greene County,"Greene County, Ohio",165811,81592,84219
5ea728146307ba36aa1dfd49,39059,05000US39059,Guernsey County,"Guernsey County, Ohio",39274,19522,19752
5ea728146307ba36aa1dfd4a,39061,05000US39061,Hamilton County,"Hamilton County, Ohio",812037,391728,420309
5ea728146307ba36aa1dfd4b,39063,05000US39063,Hancock County,"Hancock County, Ohio",75690,37306,38384
5ea728146307ba36aa1dfd4c,39065,05000US39065,Hardin County,"Hardin County, Ohio",31542,15639,15903
5ea728146307ba36aa1dfd4d,39067,05000US39067,Harrison County,"Harrison County, Ohio",15307,7566,7741
5ea728146307ba36aa1dfd4e,39069,05000US39069,Henry County,"Henry County, Ohio",27316,13440,13876
5ea728146307ba36aa1dfd4f,39071,05000US39071,Highland County,"Highland County, Ohio",43007,21136,21871
5ea728146307ba36aa1dfd50,39073,05000US39073,Hocking County,"Hocking County, Ohio",28495,14129,14366
5ea728146307ba36aa1dfd51,39075,05000US39075,Holmes County,"Holmes County, Ohio",43859,21874,21985
5ea728146307ba36aa1dfd52,39077,05000US39077,Huron County,"Huron County, Ohio",58457,28770,29687
5ea728146307ba36aa1dfd53,39079,05000US39079,Jackson County,"Jackson County, Ohio",32524,15885,16639
5ea728146307ba36aa1dfd54,39081,05000US39081,Jefferson County,"Jefferson County, Ohio",66886,32489,34397
5ea728146307ba36aa1dfd55,39083,05000US39083,Knox County,"Knox County, Ohio",61215,29959,31256
5ea728146307ba36aa1dfd56,39085,05000US39085,Lake County,"Lake County, Ohio",230052,112379,117673
5ea728146307ba36aa1dfd57,39087,05000US39087,Lawrence County,"Lawrence County, Ohio",60622,29728,30894
5ea728146307ba36aa1dfd58,39089,05000US39089,Licking County,"Licking County, Ohio",172293,84398,87895
5ea728146307ba36aa1dfd59,39091,05000US39091,Logan County,"Logan County, Ohio",45307,22336,22971
5ea728146307ba36aa1dfd5a,39093,05000US39093,Lorain County,"Lorain County, Ohio",306713,151054,155659
5ea728146307ba36aa1dfd5b,39095,05000US39095,Lucas County,"Lucas County, Ohio",432379,209580,222799
5ea728146307ba36aa1dfd5c,39097,05000US39097,Madison County,"Madison County, Ohio",43988,24041,19947
5ea728146307ba36aa1dfd5d,39099,05000US39099,Mahoning County,"Mahoning County, Ohio",231064,112742,118322
5ea728146307ba36aa1dfd5e,39101,05000US39101,Marion County,"Marion County, Ohio",65344,34700,30644
5ea728146307ba36aa1dfd5f,39103,05000US39103,Medina County,"Medina County, Ohio",177257,87695,89562
5ea728146307ba36aa1dfd60,39105,05000US39105,Meigs County,"Meigs County, Ohio",23160,11474,11686
5ea728146307ba36aa1dfd61,39107,05000US39107,Mercer County,"Mercer County, Ohio",40806,20578,20228
5ea728146307ba36aa1dfd62,39109,05000US39109,Miami County,"Miami County, Ohio",104800,51847,52953
5ea728146307ba36aa1dfd63,39111,05000US39111,Monroe County,"Monroe County, Ohio",14090,7012,7078
5ea728146307ba36aa1dfd64,39113,05000US39113,Montgomery County,"Montgomery County, Ohio",532034,256154,275880
5ea728146307ba36aa1dfd65,39115,05000US39115,Morgan County,"Morgan County, Ohio",14702,7349,7353
5ea728146307ba36aa1dfd66,39117,05000US39117,Morrow County,"Morrow County, Ohio",34976,17461,17515
5ea728146307ba36aa1dfd67,39119,05000US39119,Muskingum County,"Muskingum County, Ohio",86076,41719,44357
5ea728146307ba36aa1dfd68,39121,05000US39121,Noble County,"Noble County, Ohio",14443,8616,5827
5ea728146307ba36aa1dfd69,39123,05000US39123,Ottawa County,"Ottawa County, Ohio",40709,20215,20494
5ea728146307ba36aa1dfd6a,39125,05000US39125,Paulding County,"Paulding County, Ohio",18872,9413,9459
5ea728146307ba36aa1dfd6b,39127,05000US39127,Perry County,"Perry County, Ohio",35985,18019,17966
5ea728146307ba36aa1dfd6c,39129,05000US39129,Pickaway County,"Pickaway County, Ohio",57420,30202,27218
5ea728146307ba36aa1dfd6d,39131,05000US39131,Pike County,"Pike County, Ohio",28214,13945,14269
5ea728146307ba36aa1dfd6e,39133,05000US39133,Portage County,"Portage County, Ohio",162644,79741,82903
5ea728146307ba36aa1dfd6f,39135,05000US39135,Preble County,"Preble County, Ohio",41207,20397,20810
5ea728146307ba36aa1dfd70,39137,05000US39137,Putnam County,"Putnam County, Ohio",33969,16960,17009
5ea728146307ba36aa1dfd71,39139,05000US39139,Richland County,"Richland County, Ohio",121324,61593,59731
5ea728146307ba36aa1dfd72,39141,05000US39141,Ross County,"Ross County, Ohio",77051,40551,36500
5ea728146307ba36aa1dfd73,39143,05000US39143,Sandusky County,"Sandusky County, Ohio",59299,29394,29905
5ea728146307ba36aa1dfd74,39145,05000US39145,Scioto County,"Scioto County, Ohio",76377,37604,38773
5ea728146307ba36aa1dfd75,39147,05000US39147,Seneca County,"Seneca County, Ohio",55475,27649,27826
5ea728146307ba36aa1dfd76,39149,05000US39149,Shelby County,"Shelby County, Ohio",48797,24657,24140
5ea728146307ba36aa1dfd77,39151,05000US39151,Stark County,"Stark County, Ohio",373475,181448,192027
5ea728146307ba36aa1dfd78,39153,05000US39153,Summit County,"Summit County, Ohio",541810,262858,278952
5ea728146307ba36aa1dfd79,39155,05000US39155,Trumbull County,"Trumbull County, Ohio",201794,98467,103327
5ea728146307ba36aa1dfd7a,39157,05000US39157,Tuscarawas County,"Tuscarawas County, Ohio",92526,45411,47115
5ea728146307ba36aa1dfd7b,39159,05000US39159,Union County,"Union County, Ohio",55654,26847,28807
5ea728146307ba36aa1dfd7c,39161,05000US39161,Van Wert County,"Van Wert County, Ohio",28281,13891,14390
5ea728146307ba36aa1dfd7d,39163,05000US39163,Vinton County,"Vinton County, Ohio",13111,6584,6527
5ea728146307ba36aa1dfd7e,39165,05000US39165,Warren County,"Warren County, Ohio",226564,114030,112534
5ea728146307ba36aa1dfd7f,39167,05000US39167,Washington County,"Washington County, Ohio",60671,29953,30718
5ea728146307ba36aa1dfd80,39169,05000US39169,Wayne County,"Wayne County, Ohio",116208,57690,58518
5ea728146307ba36aa1dfd81,39171,05000US39171,Williams County,"Williams County, Ohio",36936,18266,18670
5ea728146307ba36aa1dfd82,39173,05000US39173,Wood County,"Wood County, Ohio",129936,63995,65941
5ea728146307ba36aa1dfd83,39175,05000US39175,Wyandot County,"Wyandot County, Ohio",22107,10923,11184
5ea728146307ba36aa1dfd84,40001,05000US40001,Adair County,"Adair County, Oklahoma",22113,10969,11144
5ea728146307ba36aa1dfd85,40003,05000US40003,Alfalfa County,"Alfalfa County, Oklahoma",5857,3477,2380
5ea728146307ba36aa1dfd86,40005,05000US40005,Atoka County,"Atoka County, Oklahoma",13874,7306,6568
5ea728146307ba36aa1dfd87,40007,05000US40007,Beaver County,"Beaver County, Oklahoma",5415,2756,2659
5ea728146307ba36aa1dfd88,40009,05000US40009,Beckham County,"Beckham County, Oklahoma",22621,12222,10399
5ea728146307ba36aa1dfd89,40011,05000US40011,Blaine County,"Blaine County, Oklahoma",9634,5038,4596
5ea728146307ba36aa1dfd8a,40013,05000US40013,Bryan County,"Bryan County, Oklahoma",45759,22228,23531
5ea728146307ba36aa1dfd8b,40015,05000US40015,Caddo County,"Caddo County, Oklahoma",29342,15361,13981
5ea728146307ba36aa1dfd8c,40017,05000US40017,Canadian County,"Canadian County, Oklahoma",136710,67922,68788
5ea728146307ba36aa1dfd8d,40019,05000US40019,Carter County,"Carter County, Oklahoma",48406,23494,24912
5ea728146307ba36aa1dfd8e,40021,05000US40021,Cherokee County,"Cherokee County, Oklahoma",48599,23863,24736
5ea728146307ba36aa1dfd8f,40023,05000US40023,Choctaw County,"Choctaw County, Oklahoma",14886,7170,7716
5ea728146307ba36aa1dfd90,40025,05000US40025,Cimarron County,"Cimarron County, Oklahoma",2189,1095,1094
5ea728146307ba36aa1dfd91,40027,05000US40027,Cleveland County,"Cleveland County, Oklahoma",276733,138143,138590
5ea728146307ba36aa1dfd92,40029,05000US40029,Coal County,"Coal County, Oklahoma",5618,2818,2800
5ea728146307ba36aa1dfd93,40031,05000US40031,Comanche County,"Comanche County, Oklahoma",122561,63585,58976
5ea728146307ba36aa1dfd94,40033,05000US40033,Cotton County,"Cotton County, Oklahoma",5929,2984,2945
5ea728146307ba36aa1dfd95,40035,05000US40035,Craig County,"Craig County, Oklahoma",14493,7394,7099
5ea728146307ba36aa1dfd96,40037,05000US40037,Creek County,"Creek County, Oklahoma",71160,35189,35971
5ea728146307ba36aa1dfd97,40039,05000US40039,Custer County,"Custer County, Oklahoma",29209,14413,14796
5ea728146307ba36aa1dfd98,40041,05000US40041,Delaware County,"Delaware County, Oklahoma",42112,20756,21356
5ea728146307ba36aa1dfd99,40043,05000US40043,Dewey County,"Dewey County, Oklahoma",4918,2449,2469
5ea728146307ba36aa1dfd9a,40045,05000US40045,Ellis County,"Ellis County, Oklahoma",4072,1954,2118
5ea728146307ba36aa1dfd9b,40047,05000US40047,Garfield County,"Garfield County, Oklahoma",62190,31003,31187
5ea728146307ba36aa1dfd9c,40049,05000US40049,Garvin County,"Garvin County, Oklahoma",27823,13807,14016
5ea728146307ba36aa1dfd9d,40051,05000US40051,Grady County,"Grady County, Oklahoma",54733,27348,27385
5ea728146307ba36aa1dfd9e,40053,05000US40053,Grant County,"Grant County, Oklahoma",4418,2240,2178
5ea728146307ba36aa1dfd9f,40055,05000US40055,Greer County,"Greer County, Oklahoma",5943,3419,2524
5ea728146307ba36aa1dfda0,40057,05000US40057,Harmon County,"Harmon County, Oklahoma",2721,1299,1422
5ea728146307ba36aa1dfda1,40059,05000US40059,Harper County,"Harper County, Oklahoma",3847,1887,1960
5ea728146307ba36aa1dfda2,40061,05000US40061,Haskell County,"Haskell County, Oklahoma",12704,6311,6393
5ea728146307ba36aa1dfda3,40063,05000US40063,Hughes County,"Hughes County, Oklahoma",13460,7184,6276
5ea728146307ba36aa1dfda4,40065,05000US40065,Jackson County,"Jackson County, Oklahoma",25384,12579,12805
5ea728146307ba36aa1dfda5,40067,05000US40067,Jefferson County,"Jefferson County, Oklahoma",6223,3104,3119
5ea728146307ba36aa1dfda6,40069,05000US40069,Johnston County,"Johnston County, Oklahoma",11041,5458,5583
5ea728146307ba36aa1dfda7,40071,05000US40071,Kay County,"Kay County, Oklahoma",44880,22275,22605
5ea728146307ba36aa1dfda8,40073,05000US40073,Kingfisher County,"Kingfisher County, Oklahoma",15618,7800,7818
5ea728146307ba36aa1dfda9,40075,05000US40075,Kiowa County,"Kiowa County, Oklahoma",9001,4463,4538
5ea728146307ba36aa1dfdaa,40077,05000US40077,Latimer County,"Latimer County, Oklahoma",10495,5312,5183
5ea728146307ba36aa1dfdab,40079,05000US40079,Le Flore County,"Le Flore County, Oklahoma",49909,25067,24842
5ea728146307ba36aa1dfdac,40081,05000US40081,Lincoln County,"Lincoln County, Oklahoma",34854,17326,17528
5ea728146307ba36aa1dfdad,40083,05000US40083,Logan County,"Logan County, Oklahoma",46044,22846,23198
5ea728146307ba36aa1dfdae,40085,05000US40085,Love County,"Love County, Oklahoma",9933,4958,4975
5ea728146307ba36aa1dfdaf,40087,05000US40087,McClain County,"McClain County, Oklahoma",38634,19191,19443
5ea728146307ba36aa1dfdb0,40089,05000US40089,McCurtain County,"McCurtain County, Oklahoma",32966,16217,16749
5ea728146307ba36aa1dfdb1,40091,05000US40091,McIntosh County,"McIntosh County, Oklahoma",19819,9784,10035
5ea728146307ba36aa1dfdb2,40093,05000US40093,Major County,"Major County, Oklahoma",7718,3795,3923
5ea728146307ba36aa1dfdb3,40095,05000US40095,Marshall County,"Marshall County, Oklahoma",16376,8117,8259
5ea728146307ba36aa1dfdb4,40097,05000US40097,Mayes County,"Mayes County, Oklahoma",40980,20435,20545
5ea728146307ba36aa1dfdb5,40099,05000US40099,Murray County,"Murray County, Oklahoma",13875,6954,6921
5ea728146307ba36aa1dfdb6,40101,05000US40101,Muskogee County,"Muskogee County, Oklahoma",69084,33709,35375
5ea728146307ba36aa1dfdb7,40103,05000US40103,Noble County,"Noble County, Oklahoma",11411,5625,5786
5ea728146307ba36aa1dfdb8,40105,05000US40105,Nowata County,"Nowata County, Oklahoma",10383,5125,5258
5ea728146307ba36aa1dfdb9,40107,05000US40107,Okfuskee County,"Okfuskee County, Oklahoma",12115,6486,5629
5ea728146307ba36aa1dfdba,40109,05000US40109,Oklahoma County,"Oklahoma County, Oklahoma",782051,382760,399291
5ea728146307ba36aa1dfdbb,40111,05000US40111,Okmulgee County,"Okmulgee County, Oklahoma",38889,19160,19729
5ea728146307ba36aa1dfdbc,40113,05000US40113,Osage County,"Osage County, Oklahoma",47311,23675,23636
5ea728146307ba36aa1dfdbd,40115,05000US40115,Ottawa County,"Ottawa County, Oklahoma",31566,15520,16046
5ea728146307ba36aa1dfdbe,40117,05000US40117,Pawnee County,"Pawnee County, Oklahoma",16428,8216,8212
5ea728146307ba36aa1dfdbf,40119,05000US40119,Payne County,"Payne County, Oklahoma",81512,41891,39621
5ea728146307ba36aa1dfdc0,40121,05000US40121,Pittsburg County,"Pittsburg County, Oklahoma",44382,22583,21799
5ea728146307ba36aa1dfdc1,40123,05000US40123,Pontotoc County,"Pontotoc County, Oklahoma",38358,18768,19590
5ea728146307ba36aa1dfdc2,40125,05000US40125,Pottawatomie County,"Pottawatomie County, Oklahoma",72000,34410,37590
5ea728146307ba36aa1dfdc3,40127,05000US40127,Pushmataha County,"Pushmataha County, Oklahoma",11119,5439,5680
5ea728146307ba36aa1dfdc4,40129,05000US40129,Roger Mills County,"Roger Mills County, Oklahoma",3708,1814,1894
5ea728146307ba36aa1dfdc5,40131,05000US40131,Rogers County,"Rogers County, Oklahoma",90814,45246,45568
5ea728146307ba36aa1dfdc6,40133,05000US40133,Seminole County,"Seminole County, Oklahoma",25071,12278,12793
5ea728146307ba36aa1dfdc7,40135,05000US40135,Sequoyah County,"Sequoyah County, Oklahoma",41359,20382,20977
5ea728146307ba36aa1dfdc8,40137,05000US40137,Stephens County,"Stephens County, Oklahoma",43983,21328,22655
5ea728146307ba36aa1dfdc9,40139,05000US40139,Texas County,"Texas County, Oklahoma",21121,11313,9808
5ea728146307ba36aa1dfdca,40141,05000US40141,Tillman County,"Tillman County, Oklahoma",7515,3860,3655
5ea728146307ba36aa1dfdcb,40143,05000US40143,Tulsa County,"Tulsa County, Oklahoma",642781,313659,329122
5ea728146307ba36aa1dfdcc,40145,05000US40145,Wagoner County,"Wagoner County, Oklahoma",77850,38525,39325
5ea728146307ba36aa1dfdcd,40147,05000US40147,Washington County,"Washington County, Oklahoma",52001,25253,26748
5ea728146307ba36aa1dfdce,40149,05000US40149,Washita County,"Washita County, Oklahoma",11432,5740,5692
5ea728146307ba36aa1dfdcf,40151,05000US40151,Woods County,"Woods County, Oklahoma",9127,4924,4203
5ea728146307ba36aa1dfdd0,40153,05000US40153,Woodward County,"Woodward County, Oklahoma",20967,11122,9845
5ea728146307ba36aa1dfdd1,41001,05000US41001,Baker County,"Baker County, Oregon",15984,8232,7752
5ea728146307ba36aa1dfdd2,41003,05000US41003,Benton County,"Benton County, Oregon",89780,45317,44463
5ea728146307ba36aa1dfdd3,41005,05000US41005,Clackamas County,"Clackamas County, Oregon",405788,199775,206013
5ea728146307ba36aa1dfdd4,41007,05000US41007,Clatsop County,"Clatsop County, Oregon",38562,19166,19396
5ea728146307ba36aa1dfdd5,41009,05000US41009,Columbia County,"Columbia County, Oregon",50851,25506,25345
5ea728146307ba36aa1dfdd6,41011,05000US41011,Coos County,"Coos County, Oregon",63308,31042,32266
5ea728146307ba36aa1dfdd7,41013,05000US41013,Crook County,"Crook County, Oregon",22337,10916,11421
5ea728146307ba36aa1dfdd8,41015,05000US41015,Curry County,"Curry County, Oregon",22507,11043,11464
5ea728146307ba36aa1dfdd9,41017,05000US41017,Deschutes County,"Deschutes County, Oregon",180640,89209,91431
5ea728146307ba36aa1dfdda,41019,05000US41019,Douglas County,"Douglas County, Oregon",108323,53470,54853
5ea728146307ba36aa1dfddb,41021,05000US41021,Gilliam County,"Gilliam County, Oregon",1907,912,995
5ea728146307ba36aa1dfddc,41023,05000US41023,Grant County,"Grant County, Oregon",7183,3631,3552
5ea728146307ba36aa1dfddd,41025,05000US41025,Harney County,"Harney County, Oregon",7228,3657,3571
5ea728146307ba36aa1dfdde,41027,05000US41027,Hood River County,"Hood River County, Oregon",23131,11528,11603
5ea728146307ba36aa1dfddf,41029,05000US41029,Jackson County,"Jackson County, Oregon",214267,104458,109809
5ea728146307ba36aa1dfde0,41031,05000US41031,Jefferson County,"Jefferson County, Oregon",23143,12010,11133
5ea728146307ba36aa1dfde1,41033,05000US41033,Josephine County,"Josephine County, Oregon",85481,41984,43497
5ea728146307ba36aa1dfde2,41035,05000US41035,Klamath County,"Klamath County, Oregon",66310,33142,33168
5ea728146307ba36aa1dfde3,41037,05000US41037,Lake County,"Lake County, Oregon",7843,4192,3651
5ea728146307ba36aa1dfde4,41039,05000US41039,Lane County,"Lane County, Oregon",368882,181850,187032
5ea728146307ba36aa1dfde5,41041,05000US41041,Lincoln County,"Lincoln County, Oregon",47881,23050,24831
5ea728146307ba36aa1dfde6,41043,05000US41043,Linn County,"Linn County, Oregon",122870,60623,62247
5ea728146307ba36aa1dfde7,41045,05000US41045,Malheur County,"Malheur County, Oregon",30431,16581,13850
5ea728146307ba36aa1dfde8,41047,05000US41047,Marion County,"Marion County, Oregon",335553,167333,168220
5ea728146307ba36aa1dfde9,41049,05000US41049,Morrow County,"Morrow County, Oregon",11215,5683,5532
5ea728146307ba36aa1dfdea,41051,05000US41051,Multnomah County,"Multnomah County, Oregon",798647,395653,402994
5ea728146307ba36aa1dfdeb,41053,05000US41053,Polk County,"Polk County, Oregon",81427,39563,41864
5ea728146307ba36aa1dfdec,41055,05000US41055,Sherman County,"Sherman County, Oregon",1605,871,734
5ea728146307ba36aa1dfded,41057,05000US41057,Tillamook County,"Tillamook County, Oregon",26076,13139,12937
5ea728146307ba36aa1dfdee,41059,05000US41059,Umatilla County,"Umatilla County, Oregon",76898,40110,36788
5ea728146307ba36aa1dfdef,41061,05000US41061,Union County,"Union County, Oregon",26028,12911,13117
5ea728146307ba36aa1dfdf0,41063,05000US41063,Wallowa County,"Wallowa County, Oregon",6924,3402,3522
5ea728146307ba36aa1dfdf1,41065,05000US41065,Wasco County,"Wasco County, Oregon",25866,12918,12948
5ea728146307ba36aa1dfdf2,41067,05000US41067,Washington County,"Washington County, Oregon",581821,287522,294299
5ea728146307ba36aa1dfdf3,41069,05000US41069,Wheeler County,"Wheeler County, Oregon",1426,728,698
5ea728146307ba36aa1dfdf4,41071,05000US41071,Yamhill County,"Yamhill County, Oregon",103820,51894,51926
5ea728146307ba36aa1dfdf5,42001,05000US42001,Adams County,"Adams County, Pennsylvania",102023,50224,51799
5ea728146307ba36aa1dfdf6,42003,05000US42003,Allegheny County,"Allegheny County, Pennsylvania",1225561,591630,633931
5ea728146307ba36aa1dfdf7,42005,05000US42005,Armstrong County,"Armstrong County, Pennsylvania",66331,33003,33328
5ea728146307ba36aa1dfdf8,42007,05000US42007,Beaver County,"Beaver County, Pennsylvania",166896,80949,85947
5ea728146307ba36aa1dfdf9,42009,05000US42009,Bedford County,"Bedford County, Pennsylvania",48611,24200,24411
5ea728146307ba36aa1dfdfa,42011,05000US42011,Berks County,"Berks County, Pennsylvania",416642,204883,211759
5ea728146307ba36aa1dfdfb,42013,05000US42013,Blair County,"Blair County, Pennsylvania",123842,60619,63223
5ea728146307ba36aa1dfdfc,42015,05000US42015,Bradford County,"Bradford County, Pennsylvania",61304,30206,31098
5ea728146307ba36aa1dfdfd,42017,05000US42017,Bucks County,"Bucks County, Pennsylvania",626370,307383,318987
5ea728146307ba36aa1dfdfe,42019,05000US42019,Butler County,"Butler County, Pennsylvania",186566,92301,94265
5ea728146307ba36aa1dfdff,42021,05000US42021,Cambria County,"Cambria County, Pennsylvania",134550,66180,68370
5ea728146307ba36aa1dfe00,42023,05000US42023,Cameron County,"Cameron County, Pennsylvania",4686,2369,2317
5ea728146307ba36aa1dfe01,42025,05000US42025,Carbon County,"Carbon County, Pennsylvania",63931,31783,32148
5ea728146307ba36aa1dfe02,42027,05000US42027,Centre County,"Centre County, Pennsylvania",161443,84972,76471
5ea728146307ba36aa1dfe03,42029,05000US42029,Chester County,"Chester County, Pennsylvania",517156,254746,262410
5ea728146307ba36aa1dfe04,42031,05000US42031,Clarion County,"Clarion County, Pennsylvania",38827,18962,19865
5ea728146307ba36aa1dfe05,42033,05000US42033,Clearfield County,"Clearfield County, Pennsylvania",80216,41905,38311
5ea728146307ba36aa1dfe06,42035,05000US42035,Clinton County,"Clinton County, Pennsylvania",39074,19278,19796
5ea728146307ba36aa1dfe07,42037,05000US42037,Columbia County,"Columbia County, Pennsylvania",66220,31910,34310
5ea728146307ba36aa1dfe08,42039,05000US42039,Crawford County,"Crawford County, Pennsylvania",86164,42194,43970
5ea728146307ba36aa1dfe09,42041,05000US42041,Cumberland County,"Cumberland County, Pennsylvania",247433,122321,125112
5ea728146307ba36aa1dfe0a,42043,05000US42043,Dauphin County,"Dauphin County, Pennsylvania",274515,132864,141651
5ea728146307ba36aa1dfe0b,42045,05000US42045,Delaware County,"Delaware County, Pennsylvania",563527,271056,292471
5ea728146307ba36aa1dfe0c,42047,05000US42047,Elk County,"Elk County, Pennsylvania",30608,15423,15185
5ea728146307ba36aa1dfe0d,42049,05000US42049,Erie County,"Erie County, Pennsylvania",275972,136256,139716
5ea728146307ba36aa1dfe0e,42051,05000US42051,Fayette County,"Fayette County, Pennsylvania",132289,65327,66962
5ea728146307ba36aa1dfe0f,42053,05000US42053,Forest County,"Forest County, Pennsylvania",7351,5807,1544
5ea728146307ba36aa1dfe10,42055,05000US42055,Franklin County,"Franklin County, Pennsylvania",153751,75503,78248
5ea728146307ba36aa1dfe11,42057,05000US42057,Fulton County,"Fulton County, Pennsylvania",14506,7360,7146
5ea728146307ba36aa1dfe12,42059,05000US42059,Greene County,"Greene County, Pennsylvania",37144,19304,17840
5ea728146307ba36aa1dfe13,42061,05000US42061,Huntingdon County,"Huntingdon County, Pennsylvania",45421,24052,21369
5ea728146307ba36aa1dfe14,42063,05000US42063,Indiana County,"Indiana County, Pennsylvania",85755,42835,42920
5ea728146307ba36aa1dfe15,42065,05000US42065,Jefferson County,"Jefferson County, Pennsylvania",44084,21887,22197
5ea728146307ba36aa1dfe16,42067,05000US42067,Juniata County,"Juniata County, Pennsylvania",24562,12238,12324
5ea728146307ba36aa1dfe17,42069,05000US42069,Lackawanna County,"Lackawanna County, Pennsylvania",211454,102480,108974
5ea728146307ba36aa1dfe18,42071,05000US42071,Lancaster County,"Lancaster County, Pennsylvania",538347,263680,274667
5ea728146307ba36aa1dfe19,42073,05000US42073,Lawrence County,"Lawrence County, Pennsylvania",87382,42321,45061
5ea728146307ba36aa1dfe1a,42075,05000US42075,Lebanon County,"Lebanon County, Pennsylvania",138674,67999,70675
5ea728146307ba36aa1dfe1b,42077,05000US42077,Lehigh County,"Lehigh County, Pennsylvania",362613,177051,185562
5ea728146307ba36aa1dfe1c,42079,05000US42079,Luzerne County,"Luzerne County, Pennsylvania",317884,156972,160912
5ea728146307ba36aa1dfe1d,42081,05000US42081,Lycoming County,"Lycoming County, Pennsylvania",114859,56457,58402
5ea728146307ba36aa1dfe1e,42083,05000US42083,McKean County,"McKean County, Pennsylvania",41806,21531,20275
5ea728146307ba36aa1dfe1f,42085,05000US42085,Mercer County,"Mercer County, Pennsylvania",112630,55546,57084
5ea728146307ba36aa1dfe20,42087,05000US42087,Mifflin County,"Mifflin County, Pennsylvania",46362,22744,23618
5ea728146307ba36aa1dfe21,42089,05000US42089,Monroe County,"Monroe County, Pennsylvania",167586,82895,84691
5ea728146307ba36aa1dfe22,42091,05000US42091,Montgomery County,"Montgomery County, Pennsylvania",821301,399358,421943
5ea728146307ba36aa1dfe23,42093,05000US42093,Montour County,"Montour County, Pennsylvania",18294,8846,9448
5ea728146307ba36aa1dfe24,42095,05000US42095,Northampton County,"Northampton County, Pennsylvania",301778,148366,153412
5ea728146307ba36aa1dfe25,42097,05000US42097,Northumberland County,"Northumberland County, Pennsylvania",92325,46545,45780
5ea728146307ba36aa1dfe26,42099,05000US42099,Perry County,"Perry County, Pennsylvania",45924,23184,22740
5ea728146307ba36aa1dfe27,42101,05000US42101,Philadelphia County,"Philadelphia County, Pennsylvania",1575522,745543,829979
5ea728146307ba36aa1dfe28,42103,05000US42103,Pike County,"Pike County, Pennsylvania",55498,28072,27426
5ea728146307ba36aa1dfe29,42105,05000US42105,Potter County,"Potter County, Pennsylvania",16937,8475,8462
5ea728146307ba36aa1dfe2a,42107,05000US42107,Schuylkill County,"Schuylkill County, Pennsylvania",143555,73333,70222
5ea728146307ba36aa1dfe2b,42109,05000US42109,Snyder County,"Snyder County, Pennsylvania",40466,20063,20403
5ea728146307ba36aa1dfe2c,42111,05000US42111,Somerset County,"Somerset County, Pennsylvania",74949,39038,35911
5ea728146307ba36aa1dfe2d,42113,05000US42113,Sullivan County,"Sullivan County, Pennsylvania",6177,3253,2924
5ea728146307ba36aa1dfe2e,42115,05000US42115,Susquehanna County,"Susquehanna County, Pennsylvania",41340,20794,20546
5ea728146307ba36aa1dfe2f,42117,05000US42117,Tioga County,"Tioga County, Pennsylvania",41226,20516,20710
5ea728146307ba36aa1dfe30,42119,05000US42119,Union County,"Union County, Pennsylvania",45114,24802,20312
5ea728146307ba36aa1dfe31,42121,05000US42121,Venango County,"Venango County, Pennsylvania",52376,25842,26534
5ea728146307ba36aa1dfe32,42123,05000US42123,Warren County,"Warren County, Pennsylvania",40035,20013,20022
5ea728146307ba36aa1dfe33,42125,05000US42125,Washington County,"Washington County, Pennsylvania",207547,101709,105838
5ea728146307ba36aa1dfe34,42127,05000US42127,Wayne County,"Wayne County, Pennsylvania",51536,27278,24258
5ea728146307ba36aa1dfe35,42129,05000US42129,Westmoreland County,"Westmoreland County, Pennsylvania",354751,173251,181500
5ea728146307ba36aa1dfe36,42131,05000US42131,Wyoming County,"Wyoming County, Pennsylvania",27588,13887,13701
5ea728146307ba36aa1dfe37,42133,05000US42133,York County,"York County, Pennsylvania",444014,219415,224599
5ea728146307ba36aa1dfe38,44001,05000US44001,Bristol County,"Bristol County, Rhode Island",48900,23570,25330
5ea728146307ba36aa1dfe39,44003,05000US44003,Kent County,"Kent County, Rhode Island",163861,79219,84642
5ea728146307ba36aa1dfe3a,44005,05000US44005,Newport County,"Newport County, Rhode Island",83075,40948,42127
5ea728146307ba36aa1dfe3b,44007,05000US44007,Providence County,"Providence County, Rhode Island",634533,308485,326048
5ea728146307ba36aa1dfe3c,44009,05000US44009,Washington County,"Washington County, Rhode Island",126242,61110,65132
5ea728146307ba36aa1dfe3d,45001,05000US45001,Abbeville County,"Abbeville County, South Carolina",24657,11966,12691
5ea728146307ba36aa1dfe3e,45003,05000US45003,Aiken County,"Aiken County, South Carolina",166926,80764,86162
5ea728146307ba36aa1dfe3f,45005,05000US45005,Allendale County,"Allendale County, South Carolina",9214,4913,4301
5ea728146307ba36aa1dfe40,45007,05000US45007,Anderson County,"Anderson County, South Carolina",195995,94565,101430
5ea728146307ba36aa1dfe41,45009,05000US45009,Bamberg County,"Bamberg County, South Carolina",14600,7113,7487
5ea728146307ba36aa1dfe42,45011,05000US45011,Barnwell County,"Barnwell County, South Carolina",21577,10300,11277
5ea728146307ba36aa1dfe43,45013,05000US45013,Beaufort County,"Beaufort County, South Carolina",182658,89979,92679
5ea728146307ba36aa1dfe44,45015,05000US45015,Berkeley County,"Berkeley County, South Carolina",209065,103989,105076
5ea728146307ba36aa1dfe45,45017,05000US45017,Calhoun County,"Calhoun County, South Carolina",14713,7013,7700
5ea728146307ba36aa1dfe46,45019,05000US45019,Charleston County,"Charleston County, South Carolina",394708,191191,203517
5ea728146307ba36aa1dfe47,45021,05000US45021,Cherokee County,"Cherokee County, South Carolina",56711,27529,29182
5ea728146307ba36aa1dfe48,45023,05000US45023,Chester County,"Chester County, South Carolina",32326,15747,16579
5ea728146307ba36aa1dfe49,45025,05000US45025,Chesterfield County,"Chesterfield County, South Carolina",46024,22642,23382
5ea728146307ba36aa1dfe4a,45027,05000US45027,Clarendon County,"Clarendon County, South Carolina",34017,16740,17277
5ea728146307ba36aa1dfe4b,45029,05000US45029,Colleton County,"Colleton County, South Carolina",37568,17958,19610
5ea728146307ba36aa1dfe4c,45031,05000US45031,Darlington County,"Darlington County, South Carolina",67253,31693,35560
5ea728146307ba36aa1dfe4d,45033,05000US45033,Dillon County,"Dillon County, South Carolina",30871,14567,16304
5ea728146307ba36aa1dfe4e,45035,05000US45035,Dorchester County,"Dorchester County, South Carolina",155474,75635,79839
5ea728146307ba36aa1dfe4f,45037,05000US45037,Edgefield County,"Edgefield County, South Carolina",26769,14363,12406
5ea728146307ba36aa1dfe50,45039,05000US45039,Fairfield County,"Fairfield County, South Carolina",22712,10854,11858
5ea728146307ba36aa1dfe51,45041,05000US45041,Florence County,"Florence County, South Carolina",138561,64599,73962
5ea728146307ba36aa1dfe52,45043,05000US45043,Georgetown County,"Georgetown County, South Carolina",61605,29133,32472
5ea728146307ba36aa1dfe53,45045,05000US45045,Greenville County,"Greenville County, South Carolina",498402,241853,256549
5ea728146307ba36aa1dfe54,45047,05000US45047,Greenwood County,"Greenwood County, South Carolina",70264,32553,37711
5ea728146307ba36aa1dfe55,45049,05000US45049,Hampton County,"Hampton County, South Carolina",19807,10247,9560
5ea728146307ba36aa1dfe56,45051,05000US45051,Horry County,"Horry County, South Carolina",320915,155100,165815
5ea728146307ba36aa1dfe57,45053,05000US45053,Jasper County,"Jasper County, South Carolina",27900,14070,13830
5ea728146307ba36aa1dfe58,45055,05000US45055,Kershaw County,"Kershaw County, South Carolina",64361,31261,33100
5ea728146307ba36aa1dfe59,45057,05000US45057,Lancaster County,"Lancaster County, South Carolina",89546,43592,45954
5ea728146307ba36aa1dfe5a,45059,05000US45059,Laurens County,"Laurens County, South Carolina",66710,32455,34255
5ea728146307ba36aa1dfe5b,45061,05000US45061,Lee County,"Lee County, South Carolina",17606,9164,8442
5ea728146307ba36aa1dfe5c,45063,05000US45063,Lexington County,"Lexington County, South Carolina",286316,139495,146821
5ea728146307ba36aa1dfe5d,45065,05000US45065,McCormick County,"McCormick County, South Carolina",9606,5334,4272
5ea728146307ba36aa1dfe5e,45067,05000US45067,Marion County,"Marion County, South Carolina",31562,14655,16907
5ea728146307ba36aa1dfe5f,45069,05000US45069,Marlboro County,"Marlboro County, South Carolina",27131,14236,12895
5ea728146307ba36aa1dfe60,45071,05000US45071,Newberry County,"Newberry County, South Carolina",38068,18536,19532
5ea728146307ba36aa1dfe61,45073,05000US45073,Oconee County,"Oconee County, South Carolina",76696,37801,38895
5ea728146307ba36aa1dfe62,45075,05000US45075,Orangeburg County,"Orangeburg County, South Carolina",88454,41524,46930
5ea728146307ba36aa1dfe63,45077,05000US45077,Pickens County,"Pickens County, South Carolina",122746,61190,61556
5ea728146307ba36aa1dfe64,45079,05000US45079,Richland County,"Richland County, South Carolina",408263,197835,210428
5ea728146307ba36aa1dfe65,45081,05000US45081,Saluda County,"Saluda County, South Carolina",20299,10200,10099
5ea728146307ba36aa1dfe66,45083,05000US45083,Spartanburg County,"Spartanburg County, South Carolina",302195,146535,155660
5ea728146307ba36aa1dfe67,45085,05000US45085,Sumter County,"Sumter County, South Carolina",106995,51474,55521
5ea728146307ba36aa1dfe68,45087,05000US45087,Union County,"Union County, South Carolina",27644,13228,14416
5ea728146307ba36aa1dfe69,45089,05000US45089,Williamsburg County,"Williamsburg County, South Carolina",31794,15307,16487
5ea728146307ba36aa1dfe6a,45091,05000US45091,York County,"York County, South Carolina",258641,124828,133813
5ea728146307ba36aa1dfe6b,46003,05000US46003,Aurora County,"Aurora County, South Dakota",2759,1448,1311
5ea728146307ba36aa1dfe6c,46005,05000US46005,Beadle County,"Beadle County, South Dakota",18374,9460,8914
5ea728146307ba36aa1dfe6d,46007,05000US46007,Bennett County,"Bennett County, South Dakota",3437,1620,1817
5ea728146307ba36aa1dfe6e,46009,05000US46009,Bon Homme County,"Bon Homme County, South Dakota",6969,4071,2898
5ea728146307ba36aa1dfe6f,46011,05000US46011,Brookings County,"Brookings County, South Dakota",34239,17538,16701
5ea728146307ba36aa1dfe70,46013,05000US46013,Brown County,"Brown County, South Dakota",38840,19060,19780
5ea728146307ba36aa1dfe71,46015,05000US46015,Brule County,"Brule County, South Dakota",5256,2598,2658
5ea728146307ba36aa1dfe72,46017,05000US46017,Buffalo County,"Buffalo County, South Dakota",2053,1018,1035
5ea728146307ba36aa1dfe73,46019,05000US46019,Butte County,"Butte County, South Dakota",10177,5083,5094
5ea728146307ba36aa1dfe74,46021,05000US46021,Campbell County,"Campbell County, South Dakota",1435,753,682
5ea728146307ba36aa1dfe75,46023,05000US46023,Charles Mix County,"Charles Mix County, South Dakota",9344,4693,4651
5ea728146307ba36aa1dfe76,46025,05000US46025,Clark County,"Clark County, South Dakota",3673,1876,1797
5ea728146307ba36aa1dfe77,46027,05000US46027,Clay County,"Clay County, South Dakota",13925,6879,7046
5ea728146307ba36aa1dfe78,46029,05000US46029,Codington County,"Codington County, South Dakota",27993,14080,13913
5ea728146307ba36aa1dfe79,46031,05000US46031,Corson County,"Corson County, South Dakota",4168,2113,2055
5ea728146307ba36aa1dfe7a,46033,05000US46033,Custer County,"Custer County, South Dakota",8573,4286,4287
5ea728146307ba36aa1dfe7b,46035,05000US46035,Davison County,"Davison County, South Dakota",19901,9963,9938
5ea728146307ba36aa1dfe7c,46037,05000US46037,Day County,"Day County, South Dakota",5506,2857,2649
5ea728146307ba36aa1dfe7d,46039,05000US46039,Deuel County,"Deuel County, South Dakota",4306,2255,2051
5ea728146307ba36aa1dfe7e,46041,05000US46041,Dewey County,"Dewey County, South Dakota",5779,2869,2910
5ea728146307ba36aa1dfe7f,46043,05000US46043,Douglas County,"Douglas County, South Dakota",2930,1417,1513
5ea728146307ba36aa1dfe80,46045,05000US46045,Edmunds County,"Edmunds County, South Dakota",3940,2008,1932
5ea728146307ba36aa1dfe81,46047,05000US46047,Fall River County,"Fall River County, South Dakota",6774,3404,3370
5ea728146307ba36aa1dfe82,46049,05000US46049,Faulk County,"Faulk County, South Dakota",2322,1165,1157
5ea728146307ba36aa1dfe83,46051,05000US46051,Grant County,"Grant County, South Dakota",7217,3756,3461
5ea728146307ba36aa1dfe84,46053,05000US46053,Gregory County,"Gregory County, South Dakota",4201,2144,2057
5ea728146307ba36aa1dfe85,46055,05000US46055,Haakon County,"Haakon County, South Dakota",2082,1012,1070
5ea728146307ba36aa1dfe86,46057,05000US46057,Hamlin County,"Hamlin County, South Dakota",6000,3091,2909
5ea728146307ba36aa1dfe87,46059,05000US46059,Hand County,"Hand County, South Dakota",3301,1674,1627
5ea728146307ba36aa1dfe88,46061,05000US46061,Hanson County,"Hanson County, South Dakota",3397,1709,1688
5ea728146307ba36aa1dfe89,46063,05000US46063,Harding County,"Harding County, South Dakota",1311,695,616
5ea728146307ba36aa1dfe8a,46065,05000US46065,Hughes County,"Hughes County, South Dakota",17617,8610,9007
5ea728146307ba36aa1dfe8b,46067,05000US46067,Hutchinson County,"Hutchinson County, South Dakota",7315,3605,3710
5ea728146307ba36aa1dfe8c,46069,05000US46069,Hyde County,"Hyde County, South Dakota",1331,666,665
5ea728146307ba36aa1dfe8d,46071,05000US46071,Jackson County,"Jackson County, South Dakota",3287,1611,1676
5ea728146307ba36aa1dfe8e,46073,05000US46073,Jerauld County,"Jerauld County, South Dakota",2029,996,1033
5ea728146307ba36aa1dfe8f,46075,05000US46075,Jones County,"Jones County, South Dakota",735,364,371
5ea728146307ba36aa1dfe90,46077,05000US46077,Kingsbury County,"Kingsbury County, South Dakota",4967,2537,2430
5ea728146307ba36aa1dfe91,46079,05000US46079,Lake County,"Lake County, South Dakota",12574,6569,6005
5ea728146307ba36aa1dfe92,46081,05000US46081,Lawrence County,"Lawrence County, South Dakota",25234,12595,12639
5ea728146307ba36aa1dfe93,46083,05000US46083,Lincoln County,"Lincoln County, South Dakota",54914,27152,27762
5ea728146307ba36aa1dfe94,46085,05000US46085,Lyman County,"Lyman County, South Dakota",3869,2017,1852
5ea728146307ba36aa1dfe95,46087,05000US46087,McCook County,"McCook County, South Dakota",5511,2771,2740
5ea728146307ba36aa1dfe96,46089,05000US46089,McPherson County,"McPherson County, South Dakota",2364,1192,1172
5ea728146307ba36aa1dfe97,46091,05000US46091,Marshall County,"Marshall County, South Dakota",4895,2527,2368
5ea728146307ba36aa1dfe98,46093,05000US46093,Meade County,"Meade County, South Dakota",27424,14349,13075
5ea728146307ba36aa1dfe99,46095,05000US46095,Mellette County,"Mellette County, South Dakota",2055,1026,1029
5ea728146307ba36aa1dfe9a,46097,05000US46097,Miner County,"Miner County, South Dakota",2229,1152,1077
5ea728146307ba36aa1dfe9b,46099,05000US46099,Minnehaha County,"Minnehaha County, South Dakota",186749,94085,92664
5ea728146307ba36aa1dfe9c,46101,05000US46101,Moody County,"Moody County, South Dakota",6506,3302,3204
5ea728146307ba36aa1dfe9d,46102,05000US46102,Oglala Lakota County,"Oglala Lakota County, South Dakota",14335,6989,7346
5ea728146307ba36aa1dfe9e,46103,05000US46103,Pennington County,"Pennington County, South Dakota",109294,54990,54304
5ea728146307ba36aa1dfe9f,46105,05000US46105,Perkins County,"Perkins County, South Dakota",2907,1474,1433
5ea728146307ba36aa1dfea0,46107,05000US46107,Potter County,"Potter County, South Dakota",2326,1179,1147
5ea728146307ba36aa1dfea1,46109,05000US46109,Roberts County,"Roberts County, South Dakota",10285,5290,4995
5ea728146307ba36aa1dfea2,46111,05000US46111,Sanborn County,"Sanborn County, South Dakota",2388,1233,1155
5ea728146307ba36aa1dfea3,46115,05000US46115,Spink County,"Spink County, South Dakota",6543,3280,3263
5ea728146307ba36aa1dfea4,46117,05000US46117,Stanley County,"Stanley County, South Dakota",2997,1549,1448
5ea728146307ba36aa1dfea5,46119,05000US46119,Sully County,"Sully County, South Dakota",1331,698,633
5ea728146307ba36aa1dfea6,46121,05000US46121,Todd County,"Todd County, South Dakota",10146,4979,5167
5ea728146307ba36aa1dfea7,46123,05000US46123,Tripp County,"Tripp County, South Dakota",5468,2719,2749
5ea728146307ba36aa1dfea8,46125,05000US46125,Turner County,"Turner County, South Dakota",8264,4138,4126
5ea728146307ba36aa1dfea9,46127,05000US46127,Union County,"Union County, South Dakota",15177,7693,7484
5ea728146307ba36aa1dfeaa,46129,05000US46129,Walworth County,"Walworth County, South Dakota",5510,2726,2784
5ea728146307ba36aa1dfeab,46135,05000US46135,Yankton County,"Yankton County, South Dakota",22717,11705,11012
5ea728146307ba36aa1dfeac,46137,05000US46137,Ziebach County,"Ziebach County, South Dakota",2814,1398,1416
5ea728146307ba36aa1dfead,47001,05000US47001,Anderson County,"Anderson County, Tennessee",75775,36904,38871
5ea728146307ba36aa1dfeae,47003,05000US47003,Bedford County,"Bedford County, Tennessee",47558,23409,24149
5ea728146307ba36aa1dfeaf,47005,05000US47005,Benton County,"Benton County, Tennessee",16112,7887,8225
5ea728146307ba36aa1dfeb0,47007,05000US47007,Bledsoe County,"Bledsoe County, Tennessee",14602,8517,6085
5ea728146307ba36aa1dfeb1,47009,05000US47009,Blount County,"Blount County, Tennessee",128443,62290,66153
5ea728146307ba36aa1dfeb2,47011,05000US47011,Bradley County,"Bradley County, Tennessee",104557,50905,53652
5ea728146307ba36aa1dfeb3,47013,05000US47013,Campbell County,"Campbell County, Tennessee",39687,19306,20381
5ea728146307ba36aa1dfeb4,47015,05000US47015,Cannon County,"Cannon County, Tennessee",13976,6899,7077
5ea728146307ba36aa1dfeb5,47017,05000US47017,Carroll County,"Carroll County, Tennessee",28018,13692,14326
5ea728146307ba36aa1dfeb6,47019,05000US47019,Carter County,"Carter County, Tennessee",56391,27618,28773
5ea728146307ba36aa1dfeb7,47021,05000US47021,Cheatham County,"Cheatham County, Tennessee",39929,19817,20112
5ea728146307ba36aa1dfeb8,47023,05000US47023,Chester County,"Chester County, Tennessee",17150,8207,8943
5ea728146307ba36aa1dfeb9,47025,05000US47025,Claiborne County,"Claiborne County, Tennessee",31613,15361,16252
5ea728146307ba36aa1dfeba,47027,05000US47027,Clay County,"Clay County, Tennessee",7686,3771,3915
5ea728146307ba36aa1dfebb,47029,05000US47029,Cocke County,"Cocke County, Tennessee",35336,17105,18231
5ea728146307ba36aa1dfebc,47031,05000US47031,Coffee County,"Coffee County, Tennessee",54531,26640,27891
5ea728146307ba36aa1dfebd,47033,05000US47033,Crockett County,"Crockett County, Tennessee",14499,6907,7592
5ea728146307ba36aa1dfebe,47035,05000US47035,Cumberland County,"Cumberland County, Tennessee",58634,28746,29888
5ea728146307ba36aa1dfebf,47037,05000US47037,Davidson County,"Davidson County, Tennessee",684017,329948,354069
5ea728146307ba36aa1dfec0,47039,05000US47039,Decatur County,"Decatur County, Tennessee",11683,5788,5895
5ea728146307ba36aa1dfec1,47041,05000US47041,DeKalb County,"DeKalb County, Tennessee",19601,9750,9851
5ea728146307ba36aa1dfec2,47043,05000US47043,Dickson County,"Dickson County, Tennessee",51988,25458,26530
5ea728146307ba36aa1dfec3,47045,05000US47045,Dyer County,"Dyer County, Tennessee",37576,18157,19419
5ea728146307ba36aa1dfec4,47047,05000US47047,Fayette County,"Fayette County, Tennessee",39692,19510,20182
5ea728146307ba36aa1dfec5,47049,05000US47049,Fentress County,"Fentress County, Tennessee",17994,8893,9101
5ea728146307ba36aa1dfec6,47051,05000US47051,Franklin County,"Franklin County, Tennessee",41512,20414,21098
5ea728146307ba36aa1dfec7,47053,05000US47053,Gibson County,"Gibson County, Tennessee",49175,23688,25487
5ea728146307ba36aa1dfec8,47055,05000US47055,Giles County,"Giles County, Tennessee",29167,14246,14921
5ea728146307ba36aa1dfec9,47057,05000US47057,Grainger County,"Grainger County, Tennessee",23013,11465,11548
5ea728146307ba36aa1dfeca,47059,05000US47059,Greene County,"Greene County, Tennessee",68669,33550,35119
5ea728146307ba36aa1dfecb,47061,05000US47061,Grundy County,"Grundy County, Tennessee",13331,6571,6760
5ea728146307ba36aa1dfecc,47063,05000US47063,Hamblen County,"Hamblen County, Tennessee",63740,31141,32599
5ea728146307ba36aa1dfecd,47065,05000US47065,Hamilton County,"Hamilton County, Tennessee",357546,172447,185099
5ea728146307ba36aa1dfece,47067,05000US47067,Hancock County,"Hancock County, Tennessee",6585,3293,3292
5ea728146307ba36aa1dfecf,47069,05000US47069,Hardeman County,"Hardeman County, Tennessee",25562,14088,11474
5ea728146307ba36aa1dfed0,47071,05000US47071,Hardin County,"Hardin County, Tennessee",25771,12606,13165
5ea728146307ba36aa1dfed1,47073,05000US47073,Hawkins County,"Hawkins County, Tennessee",56402,27582,28820
5ea728146307ba36aa1dfed2,47075,05000US47075,Haywood County,"Haywood County, Tennessee",17779,8246,9533
5ea728146307ba36aa1dfed3,47077,05000US47077,Henderson County,"Henderson County, Tennessee",27859,13446,14413
5ea728146307ba36aa1dfed4,47079,05000US47079,Henry County,"Henry County, Tennessee",32279,15554,16725
5ea728146307ba36aa1dfed5,47081,05000US47081,Hickman County,"Hickman County, Tennessee",24678,12910,11768
5ea728146307ba36aa1dfed6,47083,05000US47083,Houston County,"Houston County, Tennessee",8176,4066,4110
5ea728146307ba36aa1dfed7,47085,05000US47085,Humphreys County,"Humphreys County, Tennessee",18318,9013,9305
5ea728146307ba36aa1dfed8,47087,05000US47087,Jackson County,"Jackson County, Tennessee",11615,5826,5789
5ea728146307ba36aa1dfed9,47089,05000US47089,Jefferson County,"Jefferson County, Tennessee",53247,26099,27148
5ea728146307ba36aa1dfeda,47091,05000US47091,Johnson County,"Johnson County, Tennessee",17789,9682,8107
5ea728146307ba36aa1dfedb,47093,05000US47093,Knox County,"Knox County, Tennessee",456185,221667,234518
5ea728146307ba36aa1dfedc,47095,05000US47095,Lake County,"Lake County, Tennessee",7526,4642,2884
5ea728146307ba36aa1dfedd,47097,05000US47097,Lauderdale County,"Lauderdale County, Tennessee",26297,13505,12792
5ea728146307ba36aa1dfede,47099,05000US47099,Lawrence County,"Lawrence County, Tennessee",42937,21088,21849
5ea728146307ba36aa1dfedf,47101,05000US47101,Lewis County,"Lewis County, Tennessee",11956,5735,6221
5ea728146307ba36aa1dfee0,47103,05000US47103,Lincoln County,"Lincoln County, Tennessee",33711,16620,17091
5ea728146307ba36aa1dfee1,47105,05000US47105,Loudon County,"Loudon County, Tennessee",51610,25234,26376
5ea728146307ba36aa1dfee2,47107,05000US47107,McMinn County,"McMinn County, Tennessee",52773,25537,27236
5ea728146307ba36aa1dfee3,47109,05000US47109,McNairy County,"McNairy County, Tennessee",25903,12685,13218
5ea728146307ba36aa1dfee4,47111,05000US47111,Macon County,"Macon County, Tennessee",23487,11544,11943
5ea728146307ba36aa1dfee5,47113,05000US47113,Madison County,"Madison County, Tennessee",97682,46137,51545
5ea728146307ba36aa1dfee6,47115,05000US47115,Marion County,"Marion County, Tennessee",28417,13832,14585
5ea728146307ba36aa1dfee7,47117,05000US47117,Marshall County,"Marshall County, Tennessee",32269,15877,16392
5ea728146307ba36aa1dfee8,47119,05000US47119,Maury County,"Maury County, Tennessee",89776,43111,46665
5ea728146307ba36aa1dfee9,47121,05000US47121,Meigs County,"Meigs County, Tennessee",11962,5937,6025
5ea728146307ba36aa1dfeea,47123,05000US47123,Monroe County,"Monroe County, Tennessee",45876,22701,23175
5ea728146307ba36aa1dfeeb,47125,05000US47125,Montgomery County,"Montgomery County, Tennessee",196387,98123,98264
5ea728146307ba36aa1dfeec,47127,05000US47127,Moore County,"Moore County, Tennessee",6322,3101,3221
5ea728146307ba36aa1dfeed,47129,05000US47129,Morgan County,"Morgan County, Tennessee",21596,12050,9546
5ea728146307ba36aa1dfeee,47131,05000US47131,Obion County,"Obion County, Tennessee",30520,14647,15873
5ea728146307ba36aa1dfeef,47133,05000US47133,Overton County,"Overton County, Tennessee",22004,10857,11147
5ea728146307ba36aa1dfef0,47135,05000US47135,Perry County,"Perry County, Tennessee",7912,3978,3934
5ea728146307ba36aa1dfef1,47137,05000US47137,Pickett County,"Pickett County, Tennessee",5088,2575,2513
5ea728146307ba36aa1dfef2,47139,05000US47139,Polk County,"Polk County, Tennessee",16782,8369,8413
5ea728146307ba36aa1dfef3,47141,05000US47141,Putnam County,"Putnam County, Tennessee",76440,37707,38733
5ea728146307ba36aa1dfef4,47143,05000US47143,Rhea County,"Rhea County, Tennessee",32628,16106,16522
5ea728146307ba36aa1dfef5,47145,05000US47145,Roane County,"Roane County, Tennessee",52897,25931,26966
5ea728146307ba36aa1dfef6,47147,05000US47147,Robertson County,"Robertson County, Tennessee",69344,34287,35057
5ea728146307ba36aa1dfef7,47149,05000US47149,Rutherford County,"Rutherford County, Tennessee",307128,151446,155682
5ea728146307ba36aa1dfef8,47151,05000US47151,Scott County,"Scott County, Tennessee",21954,10855,11099
5ea728146307ba36aa1dfef9,47153,05000US47153,Sequatchie County,"Sequatchie County, Tennessee",14730,7331,7399
5ea728146307ba36aa1dfefa,47155,05000US47155,Sevier County,"Sevier County, Tennessee",96287,47281,49006
5ea728146307ba36aa1dfefb,47157,05000US47157,Shelby County,"Shelby County, Tennessee",937005,445994,491011
5ea728146307ba36aa1dfefc,47159,05000US47159,Smith County,"Smith County, Tennessee",19458,9675,9783
5ea728146307ba36aa1dfefd,47161,05000US47161,Stewart County,"Stewart County, Tennessee",13301,6631,6670
5ea728146307ba36aa1dfefe,47163,05000US47163,Sullivan County,"Sullivan County, Tennessee",156734,76050,80684
5ea728146307ba36aa1dfeff,47165,05000US47165,Sumner County,"Sumner County, Tennessee",179473,87811,91662
5ea728146307ba36aa1dff00,47167,05000US47167,Tipton County,"Tipton County, Tennessee",61446,30240,31206
5ea728146307ba36aa1dff01,47169,05000US47169,Trousdale County,"Trousdale County, Tennessee",9573,5302,4271
5ea728146307ba36aa1dff02,47171,05000US47171,Unicoi County,"Unicoi County, Tennessee",17780,8895,8885
5ea728146307ba36aa1dff03,47173,05000US47173,Union County,"Union County, Tennessee",19293,9556,9737
5ea728146307ba36aa1dff04,47175,05000US47175,Van Buren County,"Van Buren County, Tennessee",5704,2882,2822
5ea728146307ba36aa1dff05,47177,05000US47177,Warren County,"Warren County, Tennessee",40454,20091,20363
5ea728146307ba36aa1dff06,47179,05000US47179,Washington County,"Washington County, Tennessee",127055,61851,65204
5ea728146307ba36aa1dff07,47181,05000US47181,Wayne County,"Wayne County, Tennessee",16649,9186,7463
5ea728146307ba36aa1dff08,47183,05000US47183,Weakley County,"Weakley County, Tennessee",33626,16541,17085
5ea728146307ba36aa1dff09,47185,05000US47185,White County,"White County, Tennessee",26580,12982,13598
5ea728146307ba36aa1dff0a,47187,05000US47187,Williamson County,"Williamson County, Tennessee",218648,107021,111627
5ea728146307ba36aa1dff0b,47189,05000US47189,Wilson County,"Wilson County, Tennessee",132663,65056,67607
5ea728146307ba36aa1dff0c,48001,05000US48001,Anderson County,"Anderson County, Texas",57863,35412,22451
5ea728146307ba36aa1dff0d,48003,05000US48003,Andrews County,"Andrews County, Texas",17818,9102,8716
5ea728146307ba36aa1dff0e,48005,05000US48005,Angelina County,"Angelina County, Texas",87607,42659,44948
5ea728146307ba36aa1dff0f,48007,05000US48007,Aransas County,"Aransas County, Texas",24763,12026,12737
5ea728146307ba36aa1dff10,48009,05000US48009,Archer County,"Archer County, Texas",8789,4326,4463
5ea728146307ba36aa1dff11,48011,05000US48011,Armstrong County,"Armstrong County, Texas",1916,960,956
5ea728146307ba36aa1dff12,48013,05000US48013,Atascosa County,"Atascosa County, Texas",48828,24398,24430
5ea728146307ba36aa1dff13,48015,05000US48015,Austin County,"Austin County, Texas",29565,14684,14881
5ea728146307ba36aa1dff14,48017,05000US48017,Bailey County,"Bailey County, Texas",7092,3640,3452
5ea728146307ba36aa1dff15,48019,05000US48019,Bandera County,"Bandera County, Texas",21763,11032,10731
5ea728146307ba36aa1dff16,48021,05000US48021,Bastrop County,"Bastrop County, Texas",82577,42014,40563
5ea728146307ba36aa1dff17,48023,05000US48023,Baylor County,"Baylor County, Texas",3591,1752,1839
5ea728146307ba36aa1dff18,48025,05000US48025,Bee County,"Bee County, Texas",32691,19911,12780
5ea728146307ba36aa1dff19,48027,05000US48027,Bell County,"Bell County, Texas",342236,170918,171318
5ea728146307ba36aa1dff1a,48029,05000US48029,Bexar County,"Bexar County, Texas",1925865,950030,975835
5ea728146307ba36aa1dff1b,48031,05000US48031,Blanco County,"Blanco County, Texas",11279,5781,5498
5ea728146307ba36aa1dff1c,48033,05000US48033,Borden County,"Borden County, Texas",665,346,319
5ea728146307ba36aa1dff1d,48035,05000US48035,Bosque County,"Bosque County, Texas",18122,8935,9187
5ea728146307ba36aa1dff1e,48037,05000US48037,Bowie County,"Bowie County, Texas",93858,47275,46583
5ea728146307ba36aa1dff1f,48039,05000US48039,Brazoria County,"Brazoria County, Texas",353999,179060,174939
5ea728146307ba36aa1dff20,48041,05000US48041,Brazos County,"Brazos County, Texas",219193,111074,108119
5ea728146307ba36aa1dff21,48043,05000US48043,Brewster County,"Brewster County, Texas",9216,4558,4658
5ea728146307ba36aa1dff22,48045,05000US48045,Briscoe County,"Briscoe County, Texas",1546,831,715
5ea728146307ba36aa1dff23,48047,05000US48047,Brooks County,"Brooks County, Texas",7180,3724,3456
5ea728146307ba36aa1dff24,48049,05000US48049,Brown County,"Brown County, Texas",37834,18774,19060
5ea728146307ba36aa1dff25,48051,05000US48051,Burleson County,"Burleson County, Texas",17863,8977,8886
5ea728146307ba36aa1dff26,48053,05000US48053,Burnet County,"Burnet County, Texas",45750,22642,23108
5ea728146307ba36aa1dff27,48055,05000US48055,Caldwell County,"Caldwell County, Texas",41401,20893,20508
5ea728146307ba36aa1dff28,48057,05000US48057,Calhoun County,"Calhoun County, Texas",21807,11062,10745
5ea728146307ba36aa1dff29,48059,05000US48059,Callahan County,"Callahan County, Texas",13770,6763,7007
5ea728146307ba36aa1dff2a,48061,05000US48061,Cameron County,"Cameron County, Texas",421750,204788,216962
5ea728146307ba36aa1dff2b,48063,05000US48063,Camp County,"Camp County, Texas",12813,6220,6593
5ea728146307ba36aa1dff2c,48065,05000US48065,Carson County,"Carson County, Texas",6032,2820,3212
5ea728146307ba36aa1dff2d,48067,05000US48067,Cass County,"Cass County, Texas",30087,14692,15395
5ea728146307ba36aa1dff2e,48069,05000US48069,Castro County,"Castro County, Texas",7787,3905,3882
5ea728146307ba36aa1dff2f,48071,05000US48071,Chambers County,"Chambers County, Texas",40292,20377,19915
5ea728146307ba36aa1dff30,48073,05000US48073,Cherokee County,"Cherokee County, Texas",51903,26607,25296
5ea728146307ba36aa1dff31,48075,05000US48075,Childress County,"Childress County, Texas",7226,4449,2777
5ea728146307ba36aa1dff32,48077,05000US48077,Clay County,"Clay County, Texas",10387,5195,5192
5ea728146307ba36aa1dff33,48079,05000US48079,Cochran County,"Cochran County, Texas",2904,1491,1413
5ea728146307ba36aa1dff34,48081,05000US48081,Coke County,"Coke County, Texas",3275,1606,1669
5ea728146307ba36aa1dff35,48083,05000US48083,Coleman County,"Coleman County, Texas",8391,4220,4171
5ea728146307ba36aa1dff36,48085,05000US48085,Collin County,"Collin County, Texas",944350,464248,480102
5ea728146307ba36aa1dff37,48087,05000US48087,Collingsworth County,"Collingsworth County, Texas",2996,1496,1500
5ea728146307ba36aa1dff38,48089,05000US48089,Colorado County,"Colorado County, Texas",21022,10538,10484
5ea728146307ba36aa1dff39,48091,05000US48091,Comal County,"Comal County, Texas",135097,66793,68304
5ea728146307ba36aa1dff3a,48093,05000US48093,Comanche County,"Comanche County, Texas",13495,6738,6757
5ea728146307ba36aa1dff3b,48095,05000US48095,Concho County,"Concho County, Texas",4233,2802,1431
5ea728146307ba36aa1dff3c,48097,05000US48097,Cooke County,"Cooke County, Texas",39571,19660,19911
5ea728146307ba36aa1dff3d,48099,05000US48099,Coryell County,"Coryell County, Texas",75389,37630,37759
5ea728146307ba36aa1dff3e,48101,05000US48101,Cottle County,"Cottle County, Texas",1623,792,831
5ea728146307ba36aa1dff3f,48103,05000US48103,Crane County,"Crane County, Texas",4839,2511,2328
5ea728146307ba36aa1dff40,48105,05000US48105,Crockett County,"Crockett County, Texas",3633,1771,1862
5ea728146307ba36aa1dff41,48107,05000US48107,Crosby County,"Crosby County, Texas",5861,2921,2940
5ea728146307ba36aa1dff42,48109,05000US48109,Culberson County,"Culberson County, Texas",2241,1231,1010
5ea728146307ba36aa1dff43,48111,05000US48111,Dallam County,"Dallam County, Texas",7243,3795,3448
5ea728146307ba36aa1dff44,48113,05000US48113,Dallas County,"Dallas County, Texas",2586552,1275226,1311326
5ea728146307ba36aa1dff45,48115,05000US48115,Dawson County,"Dawson County, Texas",12964,7235,5729
5ea728146307ba36aa1dff46,48117,05000US48117,Deaf Smith County,"Deaf Smith County, Texas",18899,9507,9392
5ea728146307ba36aa1dff47,48119,05000US48119,Delta County,"Delta County, Texas",5215,2527,2688
5ea728146307ba36aa1dff48,48121,05000US48121,Denton County,"Denton County, Texas",807047,397140,409907
5ea728146307ba36aa1dff49,48123,05000US48123,DeWitt County,"DeWitt County, Texas",20435,10577,9858
5ea728146307ba36aa1dff4a,48125,05000US48125,Dickens County,"Dickens County, Texas",2216,1143,1073
5ea728146307ba36aa1dff4b,48127,05000US48127,Dimmit County,"Dimmit County, Texas",10663,5186,5477
5ea728146307ba36aa1dff4c,48129,05000US48129,Donley County,"Donley County, Texas",3387,1634,1753
5ea728146307ba36aa1dff4d,48131,05000US48131,Duval County,"Duval County, Texas",11355,5758,5597
5ea728146307ba36aa1dff4e,48133,05000US48133,Eastland County,"Eastland County, Texas",18270,9245,9025
5ea728146307ba36aa1dff4f,48135,05000US48135,Ector County,"Ector County, Texas",158342,80249,78093
5ea728146307ba36aa1dff50,48137,05000US48137,Edwards County,"Edwards County, Texas",2055,1062,993
5ea728146307ba36aa1dff51,48139,05000US48139,Ellis County,"Ellis County, Texas",168838,83184,85654
5ea728146307ba36aa1dff52,48141,05000US48141,El Paso County,"El Paso County, Texas",837654,411682,425972
5ea728146307ba36aa1dff53,48143,05000US48143,Erath County,"Erath County, Texas",41482,20216,21266
5ea728146307ba36aa1dff54,48145,05000US48145,Falls County,"Falls County, Texas",17299,8189,9110
5ea728146307ba36aa1dff55,48147,05000US48147,Fannin County,"Fannin County, Texas",34175,18034,16141
5ea728146307ba36aa1dff56,48149,05000US48149,Fayette County,"Fayette County, Texas",25066,12351,12715
5ea728146307ba36aa1dff57,48151,05000US48151,Fisher County,"Fisher County, Texas",3883,1879,2004
5ea728146307ba36aa1dff58,48153,05000US48153,Floyd County,"Floyd County, Texas",5872,2885,2987
5ea728146307ba36aa1dff59,48155,05000US48155,Foard County,"Foard County, Texas",1408,712,696
5ea728146307ba36aa1dff5a,48157,05000US48157,Fort Bend County,"Fort Bend County, Texas",739342,363177,376165
5ea728146307ba36aa1dff5b,48159,05000US48159,Franklin County,"Franklin County, Texas",10679,5362,5317
5ea728146307ba36aa1dff5c,48161,05000US48161,Freestone County,"Freestone County, Texas",19709,10163,9546
5ea728146307ba36aa1dff5d,48163,05000US48163,Frio County,"Frio County, Texas",19394,11580,7814
5ea728146307ba36aa1dff5e,48165,05000US48165,Gaines County,"Gaines County, Texas",20321,10320,10001
5ea728146307ba36aa1dff5f,48167,05000US48167,Galveston County,"Galveston County, Texas",327089,161269,165820
5ea728146307ba36aa1dff60,48169,05000US48169,Garza County,"Garza County, Texas",6288,4070,2218
5ea728146307ba36aa1dff61,48171,05000US48171,Gillespie County,"Gillespie County, Texas",26208,12731,13477
5ea728146307ba36aa1dff62,48173,05000US48173,Glasscock County,"Glasscock County, Texas",1430,787,643
5ea728146307ba36aa1dff63,48175,05000US48175,Goliad County,"Goliad County, Texas",7531,3734,3797
5ea728146307ba36aa1dff64,48177,05000US48177,Gonzales County,"Gonzales County, Texas",20667,10448,10219
5ea728146307ba36aa1dff65,48179,05000US48179,Gray County,"Gray County, Texas",22685,11903,10782
5ea728146307ba36aa1dff66,48181,05000US48181,Grayson County,"Grayson County, Texas",128560,62737,65823
5ea728146307ba36aa1dff67,48183,05000US48183,Gregg County,"Gregg County, Texas",123494,60208,63286
5ea728146307ba36aa1dff68,48185,05000US48185,Grimes County,"Grimes County, Texas",27630,14892,12738
5ea728146307ba36aa1dff69,48187,05000US48187,Guadalupe County,"Guadalupe County, Texas",155137,76850,78287
5ea728146307ba36aa1dff6a,48189,05000US48189,Hale County,"Hale County, Texas",34113,17751,16362
5ea728146307ba36aa1dff6b,48191,05000US48191,Hall County,"Hall County, Texas",3074,1546,1528
5ea728146307ba36aa1dff6c,48193,05000US48193,Hamilton County,"Hamilton County, Texas",8269,4070,4199
5ea728146307ba36aa1dff6d,48195,05000US48195,Hansford County,"Hansford County, Texas",5547,2783,2764
5ea728146307ba36aa1dff6e,48197,05000US48197,Hardeman County,"Hardeman County, Texas",3952,1938,2014
5ea728146307ba36aa1dff6f,48199,05000US48199,Hardin County,"Hardin County, Texas",56379,27342,29037
5ea728146307ba36aa1dff70,48201,05000US48201,Harris County,"Harris County, Texas",4602523,2288295,2314228
5ea728146307ba36aa1dff71,48203,05000US48203,Harrison County,"Harrison County, Texas",66645,32556,34089
5ea728146307ba36aa1dff72,48205,05000US48205,Hartley County,"Hartley County, Texas",5767,3411,2356
5ea728146307ba36aa1dff73,48207,05000US48207,Haskell County,"Haskell County, Texas",5809,3071,2738
5ea728146307ba36aa1dff74,48209,05000US48209,Hays County,"Hays County, Texas",204150,101636,102514
5ea728146307ba36aa1dff75,48211,05000US48211,Hemphill County,"Hemphill County, Texas",4061,1965,2096
5ea728146307ba36aa1dff76,48213,05000US48213,Henderson County,"Henderson County, Texas",80460,39097,41363
5ea728146307ba36aa1dff77,48215,05000US48215,Hidalgo County,"Hidalgo County, Texas",849389,415443,433946
5ea728146307ba36aa1dff78,48217,05000US48217,Hill County,"Hill County, Texas",35399,17603,17796
5ea728146307ba36aa1dff79,48219,05000US48219,Hockley County,"Hockley County, Texas",23162,11428,11734
5ea728146307ba36aa1dff7a,48221,05000US48221,Hood County,"Hood County, Texas",56901,28004,28897
5ea728146307ba36aa1dff7b,48223,05000US48223,Hopkins County,"Hopkins County, Texas",36240,17801,18439
5ea728146307ba36aa1dff7c,48225,05000US48225,Houston County,"Houston County, Texas",22955,12432,10523
5ea728146307ba36aa1dff7d,48227,05000US48227,Howard County,"Howard County, Texas",36667,20732,15935
5ea728146307ba36aa1dff7e,48229,05000US48229,Hudspeth County,"Hudspeth County, Texas",4098,2019,2079
5ea728146307ba36aa1dff7f,48231,05000US48231,Hunt County,"Hunt County, Texas",92152,45279,46873
5ea728146307ba36aa1dff80,48233,05000US48233,Hutchinson County,"Hutchinson County, Texas",21571,10797,10774
5ea728146307ba36aa1dff81,48235,05000US48235,Irion County,"Irion County, Texas",1524,836,688
5ea728146307ba36aa1dff82,48237,05000US48237,Jack County,"Jack County, Texas",8842,4987,3855
5ea728146307ba36aa1dff83,48239,05000US48239,Jackson County,"Jackson County, Texas",14820,7226,7594
5ea728146307ba36aa1dff84,48241,05000US48241,Jasper County,"Jasper County, Texas",35504,17501,18003
5ea728146307ba36aa1dff85,48243,05000US48243,Jeff Davis County,"Jeff Davis County, Texas",2234,1114,1120
5ea728146307ba36aa1dff86,48245,05000US48245,Jefferson County,"Jefferson County, Texas",255210,130660,124550
5ea728146307ba36aa1dff87,48247,05000US48247,Jim Hogg County,"Jim Hogg County, Texas",5282,2550,2732
5ea728146307ba36aa1dff88,48249,05000US48249,Jim Wells County,"Jim Wells County, Texas",41192,20178,21014
5ea728146307ba36aa1dff89,48251,05000US48251,Johnson County,"Johnson County, Texas",163475,81568,81907
5ea728146307ba36aa1dff8a,48253,05000US48253,Jones County,"Jones County, Texas",19891,12507,7384
5ea728146307ba36aa1dff8b,48255,05000US48255,Karnes County,"Karnes County, Texas",15387,9133,6254
5ea728146307ba36aa1dff8c,48257,05000US48257,Kaufman County,"Kaufman County, Texas",118910,58360,60550
5ea728146307ba36aa1dff8d,48259,05000US48259,Kendall County,"Kendall County, Texas",41982,20415,21567
5ea728146307ba36aa1dff8e,48261,05000US48261,Kenedy County,"Kenedy County, Texas",595,286,309
5ea728146307ba36aa1dff8f,48263,05000US48263,Kent County,"Kent County, Texas",749,327,422
5ea728146307ba36aa1dff90,48265,05000US48265,Kerr County,"Kerr County, Texas",51365,24886,26479
5ea728146307ba36aa1dff91,48267,05000US48267,Kimble County,"Kimble County, Texas",4408,2154,2254
5ea728146307ba36aa1dff92,48269,05000US48269,King County,"King County, Texas",228,118,110
5ea728146307ba36aa1dff93,48271,05000US48271,Kinney County,"Kinney County, Texas",3675,2290,1385
5ea728146307ba36aa1dff94,48273,05000US48273,Kleberg County,"Kleberg County, Texas",31425,16052,15373
5ea728146307ba36aa1dff95,48275,05000US48275,Knox County,"Knox County, Texas",3733,1853,1880
5ea728146307ba36aa1dff96,48277,05000US48277,Lamar County,"Lamar County, Texas",49532,23917,25615
5ea728146307ba36aa1dff97,48279,05000US48279,Lamb County,"Lamb County, Texas",13262,6710,6552
5ea728146307ba36aa1dff98,48281,05000US48281,Lampasas County,"Lampasas County, Texas",20640,10187,10453
5ea728146307ba36aa1dff99,48283,05000US48283,La Salle County,"La Salle County, Texas",7409,4408,3001
5ea728146307ba36aa1dff9a,48285,05000US48285,Lavaca County,"Lavaca County, Texas",19941,9684,10257
5ea728146307ba36aa1dff9b,48287,05000US48287,Lee County,"Lee County, Texas",16952,8558,8394
5ea728146307ba36aa1dff9c,48289,05000US48289,Leon County,"Leon County, Texas",17098,8602,8496
5ea728146307ba36aa1dff9d,48291,05000US48291,Liberty County,"Liberty County, Texas",81862,40439,41423
5ea728146307ba36aa1dff9e,48293,05000US48293,Limestone County,"Limestone County, Texas",23515,12056,11459
5ea728146307ba36aa1dff9f,48295,05000US48295,Lipscomb County,"Lipscomb County, Texas",3469,1840,1629
5ea728146307ba36aa1dffa0,48297,05000US48297,Live Oak County,"Live Oak County, Texas",12123,6634,5489
5ea728146307ba36aa1dffa1,48299,05000US48299,Llano County,"Llano County, Texas",20640,10138,10502
5ea728146307ba36aa1dffa2,48301,05000US48301,Loving County,"Loving County, Texas",102,58,44
5ea728146307ba36aa1dffa3,48303,05000US48303,Lubbock County,"Lubbock County, Texas",301454,148631,152823
5ea728146307ba36aa1dffa4,48305,05000US48305,Lynn County,"Lynn County, Texas",5808,2977,2831
5ea728146307ba36aa1dffa5,48307,05000US48307,McCulloch County,"McCulloch County, Texas",8098,4260,3838
5ea728146307ba36aa1dffa6,48309,05000US48309,McLennan County,"McLennan County, Texas",248429,121359,127070
5ea728146307ba36aa1dffa7,48311,05000US48311,McMullen County,"McMullen County, Texas",662,387,275
5ea728146307ba36aa1dffa8,48313,05000US48313,Madison County,"Madison County, Texas",14128,8127,6001
5ea728146307ba36aa1dffa9,48315,05000US48315,Marion County,"Marion County, Texas",10083,4915,5168
5ea728146307ba36aa1dffaa,48317,05000US48317,Martin County,"Martin County, Texas",5614,2934,2680
5ea728146307ba36aa1dffab,48319,05000US48319,Mason County,"Mason County, Texas",4161,2146,2015
5ea728146307ba36aa1dffac,48321,05000US48321,Matagorda County,"Matagorda County, Texas",36743,18319,18424
5ea728146307ba36aa1dffad,48323,05000US48323,Maverick County,"Maverick County, Texas",57970,28736,29234
5ea728146307ba36aa1dffae,48325,05000US48325,Medina County,"Medina County, Texas",49334,25551,23783
5ea728146307ba36aa1dffaf,48327,05000US48327,Menard County,"Menard County, Texas",2123,1117,1006
5ea728146307ba36aa1dffb0,48329,05000US48329,Midland County,"Midland County, Texas",164194,82543,81651
5ea728146307ba36aa1dffb1,48331,05000US48331,Milam County,"Milam County, Texas",24664,12343,12321
5ea728146307ba36aa1dffb2,48333,05000US48333,Mills County,"Mills County, Texas",4902,2329,2573
5ea728146307ba36aa1dffb3,48335,05000US48335,Mitchell County,"Mitchell County, Texas",8558,5383,3175
5ea728146307ba36aa1dffb4,48337,05000US48337,Montague County,"Montague County, Texas",19409,9403,10006
5ea728146307ba36aa1dffb5,48339,05000US48339,Montgomery County,"Montgomery County, Texas",554445,274604,279841
5ea728146307ba36aa1dffb6,48341,05000US48341,Moore County,"Moore County, Texas",21801,11438,10363
5ea728146307ba36aa1dffb7,48343,05000US48343,Morris County,"Morris County, Texas",12424,5981,6443
5ea728146307ba36aa1dffb8,48345,05000US48345,Motley County,"Motley County, Texas",1156,580,576
5ea728146307ba36aa1dffb9,48347,05000US48347,Nacogdoches County,"Nacogdoches County, Texas",65558,31365,34193
5ea728146307ba36aa1dffba,48349,05000US48349,Navarro County,"Navarro County, Texas",48583,23845,24738
5ea728146307ba36aa1dffbb,48351,05000US48351,Newton County,"Newton County, Texas",14057,7233,6824
5ea728146307ba36aa1dffbc,48353,05000US48353,Nolan County,"Nolan County, Texas",14966,7669,7297
5ea728146307ba36aa1dffbd,48355,05000US48355,Nueces County,"Nueces County, Texas",360486,178020,182466
5ea728146307ba36aa1dffbe,48357,05000US48357,Ochiltree County,"Ochiltree County, Texas",10348,5230,5118
5ea728146307ba36aa1dffbf,48359,05000US48359,Oldham County,"Oldham County, Texas",2090,1145,945
5ea728146307ba36aa1dffc0,48361,05000US48361,Orange County,"Orange County, Texas",84047,41630,42417
5ea728146307ba36aa1dffc1,48363,05000US48363,Palo Pinto County,"Palo Pinto County, Texas",28317,13987,14330
5ea728146307ba36aa1dffc2,48365,05000US48365,Panola County,"Panola County, Texas",23440,11498,11942
5ea728146307ba36aa1dffc3,48367,05000US48367,Parker County,"Parker County, Texas",129802,64448,65354
5ea728146307ba36aa1dffc4,48369,05000US48369,Parmer County,"Parmer County, Texas",9852,5059,4793
5ea728146307ba36aa1dffc5,48371,05000US48371,Pecos County,"Pecos County, Texas",15797,9010,6787
5ea728146307ba36aa1dffc6,48373,05000US48373,Polk County,"Polk County, Texas",47837,25878,21959
5ea728146307ba36aa1dffc7,48375,05000US48375,Potter County,"Potter County, Texas",120899,62295,58604
5ea728146307ba36aa1dffc8,48377,05000US48377,Presidio County,"Presidio County, Texas",7123,3497,3626
5ea728146307ba36aa1dffc9,48379,05000US48379,Rains County,"Rains County, Texas",11473,5868,5605
5ea728146307ba36aa1dffca,48381,05000US48381,Randall County,"Randall County, Texas",132475,65083,67392
5ea728146307ba36aa1dffcb,48383,05000US48383,Reagan County,"Reagan County, Texas",3752,1951,1801
5ea728146307ba36aa1dffcc,48385,05000US48385,Real County,"Real County, Texas",3389,1426,1963
5ea728146307ba36aa1dffcd,48387,05000US48387,Red River County,"Red River County, Texas",12275,5986,6289
5ea728146307ba36aa1dffce,48389,05000US48389,Reeves County,"Reeves County, Texas",15125,8689,6436
5ea728146307ba36aa1dffcf,48391,05000US48391,Refugio County,"Refugio County, Texas",7236,3586,3650
5ea728146307ba36aa1dffd0,48393,05000US48393,Roberts County,"Roberts County, Texas",885,401,484
5ea728146307ba36aa1dffd1,48395,05000US48395,Robertson County,"Robertson County, Texas",16890,8296,8594
5ea728146307ba36aa1dffd2,48397,05000US48397,Rockwall County,"Rockwall County, Texas",93642,46167,47475
5ea728146307ba36aa1dffd3,48399,05000US48399,Runnels County,"Runnels County, Texas",10310,5233,5077
5ea728146307ba36aa1dffd4,48401,05000US48401,Rusk County,"Rusk County, Texas",53595,28379,25216
5ea728146307ba36aa1dffd5,48403,05000US48403,Sabine County,"Sabine County, Texas",10458,5072,5386
5ea728146307ba36aa1dffd6,48405,05000US48405,San Augustine County,"San Augustine County, Texas",8327,4085,4242
5ea728146307ba36aa1dffd7,48407,05000US48407,San Jacinto County,"San Jacinto County, Texas",27819,13718,14101
5ea728146307ba36aa1dffd8,48409,05000US48409,San Patricio County,"San Patricio County, Texas",67046,33721,33325
5ea728146307ba36aa1dffd9,48411,05000US48411,San Saba County,"San Saba County, Texas",5962,3073,2889
5ea728146307ba36aa1dffda,48413,05000US48413,Schleicher County,"Schleicher County, Texas",3061,1542,1519
5ea728146307ba36aa1dffdb,48415,05000US48415,Scurry County,"Scurry County, Texas",17239,9425,7814
5ea728146307ba36aa1dffdc,48417,05000US48417,Shackelford County,"Shackelford County, Texas",3311,1770,1541
5ea728146307ba36aa1dffdd,48419,05000US48419,Shelby County,"Shelby County, Texas",25478,12572,12906
5ea728146307ba36aa1dffde,48421,05000US48421,Sherman County,"Sherman County, Texas",3058,1574,1484
5ea728146307ba36aa1dffdf,48423,05000US48423,Smith County,"Smith County, Texas",225015,108730,116285
5ea728146307ba36aa1dffe0,48425,05000US48425,Somervell County,"Somervell County, Texas",8743,4192,4551
5ea728146307ba36aa1dffe1,48427,05000US48427,Starr County,"Starr County, Texas",63894,31073,32821
5ea728146307ba36aa1dffe2,48429,05000US48429,Stephens County,"Stephens County, Texas",9372,4808,4564
5ea728146307ba36aa1dffe3,48431,05000US48431,Sterling County,"Sterling County, Texas",1141,622,519
5ea728146307ba36aa1dffe4,48433,05000US48433,Stonewall County,"Stonewall County, Texas",1385,730,655
5ea728146307ba36aa1dffe5,48435,05000US48435,Sutton County,"Sutton County, Texas",3865,2116,1749
5ea728146307ba36aa1dffe6,48437,05000US48437,Swisher County,"Swisher County, Texas",7484,4036,3448
5ea728146307ba36aa1dffe7,48439,05000US48439,Tarrant County,"Tarrant County, Texas",2019977,988765,1031212
5ea728146307ba36aa1dffe8,48441,05000US48441,Taylor County,"Taylor County, Texas",136348,66718,69630
5ea728146307ba36aa1dffe9,48443,05000US48443,Terrell County,"Terrell County, Texas",862,429,433
5ea728146307ba36aa1dffea,48445,05000US48445,Terry County,"Terry County, Texas",12615,6515,6100
5ea728146307ba36aa1dffeb,48447,05000US48447,Throckmorton County,"Throckmorton County, Texas",1567,694,873
5ea728146307ba36aa1dffec,48449,05000US48449,Titus County,"Titus County, Texas",32730,16046,16684
5ea728146307ba36aa1dffed,48451,05000US48451,Tom Green County,"Tom Green County, Texas",117466,58343,59123
5ea728146307ba36aa1dffee,48453,05000US48453,Travis County,"Travis County, Texas",1203166,607356,595810
5ea728146307ba36aa1dffef,48455,05000US48455,Trinity County,"Trinity County, Texas",14569,7011,7558
5ea728146307ba36aa1dfff0,48457,05000US48457,Tyler County,"Tyler County, Texas",21496,11738,9758
5ea728146307ba36aa1dfff1,48459,05000US48459,Upshur County,"Upshur County, Texas",40769,20224,20545
5ea728146307ba36aa1dfff2,48461,05000US48461,Upton County,"Upton County, Texas",3634,1843,1791
5ea728146307ba36aa1dfff3,48463,05000US48463,Uvalde County,"Uvalde County, Texas",27009,13083,13926
5ea728146307ba36aa1dfff4,48465,05000US48465,Val Verde County,"Val Verde County, Texas",49027,24925,24102
5ea728146307ba36aa1dfff5,48467,05000US48467,Van Zandt County,"Van Zandt County, Texas",54368,26619,27749
5ea728146307ba36aa1dfff6,48469,05000US48469,Victoria County,"Victoria County, Texas",91970,44999,46971
5ea728146307ba36aa1dfff7,48471,05000US48471,Walker County,"Walker County, Texas",71539,41642,29897
5ea728146307ba36aa1dfff8,48473,05000US48473,Waller County,"Waller County, Texas",49987,24869,25118
5ea728146307ba36aa1dfff9,48475,05000US48475,Ward County,"Ward County, Texas",11586,5864,5722
5ea728146307ba36aa1dfffa,48477,05000US48477,Washington County,"Washington County, Texas",34796,17259,17537
5ea728146307ba36aa1dfffb,48479,05000US48479,Webb County,"Webb County, Texas",272053,132906,139147
5ea728146307ba36aa1dfffc,48481,05000US48481,Wharton County,"Wharton County, Texas",41551,20395,21156
5ea728146307ba36aa1dfffd,48483,05000US48483,Wheeler County,"Wheeler County, Texas",5482,2844,2638
5ea728146307ba36aa1dfffe,48485,05000US48485,Wichita County,"Wichita County, Texas",131818,68325,63493
5ea728146307ba36aa1dffff,48487,05000US48487,Wilbarger County,"Wilbarger County, Texas",12906,6347,6559
5ea728146307ba36aa1e0000,48489,05000US48489,Willacy County,"Willacy County, Texas",21754,11681,10073
5ea728146307ba36aa1e0001,48491,05000US48491,Williamson County,"Williamson County, Texas",527057,259443,267614
5ea728146307ba36aa1e0002,48493,05000US48493,Wilson County,"Wilson County, Texas",48198,24197,24001
5ea728146307ba36aa1e0003,48495,05000US48495,Winkler County,"Winkler County, Texas",7802,3977,3825
5ea728146307ba36aa1e0004,48497,05000US48497,Wise County,"Wise County, Texas",64639,32424,32215
5ea728146307ba36aa1e0005,48499,05000US48499,Wood County,"Wood County, Texas",43815,21807,22008
5ea728146307ba36aa1e0006,48501,05000US48501,Yoakum County,"Yoakum County, Texas",8571,4438,4133
5ea728146307ba36aa1e0007,48503,05000US48503,Young County,"Young County, Texas",18114,8930,9184
5ea728146307ba36aa1e0008,48505,05000US48505,Zapata County,"Zapata County, Texas",14369,7177,7192
5ea728146307ba36aa1e0009,48507,05000US48507,Zavala County,"Zavala County, Texas",12131,6208,5923
5ea728146307ba36aa1e000a,49001,05000US49001,Beaver County,"Beaver County, Utah",6443,3280,3163
5ea728146307ba36aa1e000b,49003,05000US49003,Box Elder County,"Box Elder County, Utah",53001,26887,26114
5ea728146307ba36aa1e000c,49005,05000US49005,Cache County,"Cache County, Utah",122336,61354,60982
5ea728146307ba36aa1e000d,49007,05000US49007,Carbon County,"Carbon County, Utah",20356,10055,10301
5ea728146307ba36aa1e000e,49009,05000US49009,Daggett County,"Daggett County, Utah",612,359,253
5ea728146307ba36aa1e000f,49011,05000US49011,Davis County,"Davis County, Utah",340621,171584,169037
5ea728146307ba36aa1e0010,49013,05000US49013,Duchesne County,"Duchesne County, Utah",20219,10312,9907
5ea728146307ba36aa1e0011,49015,05000US49015,Emery County,"Emery County, Utah",10248,5234,5014
5ea728146307ba36aa1e0012,49017,05000US49017,Garfield County,"Garfield County, Utah",5017,2594,2423
5ea728146307ba36aa1e0013,49019,05000US49019,Grand County,"Grand County, Utah",9616,4779,4837
5ea728146307ba36aa1e0014,49021,05000US49021,Iron County,"Iron County, Utah",49691,24834,24857
5ea728146307ba36aa1e0015,49023,05000US49023,Juab County,"Juab County, Utah",10948,5590,5358
5ea728146307ba36aa1e0016,49025,05000US49025,Kane County,"Kane County, Utah",7350,3693,3657
5ea728146307ba36aa1e0017,49027,05000US49027,Millard County,"Millard County, Utah",12733,6545,6188
5ea728146307ba36aa1e0018,49029,05000US49029,Morgan County,"Morgan County, Utah",11391,5824,5567
5ea728146307ba36aa1e0019,49031,05000US49031,Piute County,"Piute County, Utah",1904,1020,884
5ea728146307ba36aa1e001a,49033,05000US49033,Rich County,"Rich County, Utah",2350,1152,1198
5ea728146307ba36aa1e001b,49035,05000US49035,Salt Lake County,"Salt Lake County, Utah",1120805,562543,558262
5ea728146307ba36aa1e001c,49037,05000US49037,San Juan County,"San Juan County, Utah",15281,7670,7611
5ea728146307ba36aa1e001d,49039,05000US49039,Sanpete County,"Sanpete County, Utah",29366,15412,13954
5ea728146307ba36aa1e001e,49041,05000US49041,Sevier County,"Sevier County, Utah",21118,10815,10303
5ea728146307ba36aa1e001f,49043,05000US49043,Summit County,"Summit County, Utah",40511,20766,19745
5ea728146307ba36aa1e0020,49045,05000US49045,Tooele County,"Tooele County, Utah",65185,32871,32314
5ea728146307ba36aa1e0021,49047,05000US49047,Uintah County,"Uintah County, Utah",36323,18496,17827
5ea728146307ba36aa1e0022,49049,05000US49049,Utah County,"Utah County, Utah",590440,298256,292184
5ea728146307ba36aa1e0023,49051,05000US49051,Wasatch County,"Wasatch County, Utah",30523,15544,14979
5ea728146307ba36aa1e0024,49053,05000US49053,Washington County,"Washington County, Utah",160537,79500,81037
5ea728146307ba36aa1e0025,49055,05000US49055,Wayne County,"Wayne County, Utah",2694,1397,1297
5ea728146307ba36aa1e0026,49057,05000US49057,Weber County,"Weber County, Utah",247731,124402,123329
5ea728146307ba36aa1e0027,50001,05000US50001,Addison County,"Addison County, Vermont",36939,18272,18667
5ea728146307ba36aa1e0028,50003,05000US50003,Bennington County,"Bennington County, Vermont",35920,17611,18309
5ea728146307ba36aa1e0029,50005,05000US50005,Caledonia County,"Caledonia County, Vermont",30425,15218,15207
5ea728146307ba36aa1e002a,50007,05000US50007,Chittenden County,"Chittenden County, Vermont",162052,79547,82505
5ea728146307ba36aa1e002b,50009,05000US50009,Essex County,"Essex County, Vermont",6208,3135,3073
5ea728146307ba36aa1e002c,50011,05000US50011,Franklin County,"Franklin County, Vermont",49025,24357,24668
5ea728146307ba36aa1e002d,50013,05000US50013,Grand Isle County,"Grand Isle County, Vermont",6965,3476,3489
5ea728146307ba36aa1e002e,50015,05000US50015,Lamoille County,"Lamoille County, Vermont",25268,12591,12677
5ea728146307ba36aa1e002f,50017,05000US50017,Orange County,"Orange County, Vermont",28937,14357,14580
5ea728146307ba36aa1e0030,50019,05000US50019,Orleans County,"Orleans County, Vermont",26911,13525,13386
5ea728146307ba36aa1e0031,50021,05000US50021,Rutland County,"Rutland County, Vermont",59273,29079,30194
5ea728146307ba36aa1e0032,50023,05000US50023,Washington County,"Washington County, Vermont",58477,28816,29661
5ea728146307ba36aa1e0033,50025,05000US50025,Windham County,"Windham County, Vermont",43150,20937,22213
5ea728146307ba36aa1e0034,50027,05000US50027,Windsor County,"Windsor County, Vermont",55427,27052,28375
5ea728146307ba36aa1e0035,51001,05000US51001,Accomack County,"Accomack County, Virginia",32742,15861,16881
5ea728146307ba36aa1e0036,51003,05000US51003,Albemarle County,"Albemarle County, Virginia",106355,50856,55499
5ea728146307ba36aa1e0037,51005,05000US51005,Alleghany County,"Alleghany County, Virginia",15286,7520,7766
5ea728146307ba36aa1e0038,51007,05000US51007,Amelia County,"Amelia County, Virginia",12854,6652,6202
5ea728146307ba36aa1e0039,51009,05000US51009,Amherst County,"Amherst County, Virginia",31882,15358,16524
5ea728146307ba36aa1e003a,51011,05000US51011,Appomattox County,"Appomattox County, Virginia",15577,7563,8014
5ea728146307ba36aa1e003b,51013,05000US51013,Arlington County,"Arlington County, Virginia",231803,115819,115984
5ea728146307ba36aa1e003c,51015,05000US51015,Augusta County,"Augusta County, Virginia",74701,37897,36804
5ea728146307ba36aa1e003d,51017,05000US51017,Bath County,"Bath County, Virginia",4393,2310,2083
5ea728146307ba36aa1e003e,51019,05000US51019,Bedford County,"Bedford County, Virginia",77908,38306,39602
5ea728146307ba36aa1e003f,51021,05000US51021,Bland County,"Bland County, Virginia",6447,3542,2905
5ea728146307ba36aa1e0040,51023,05000US51023,Botetourt County,"Botetourt County, Virginia",33222,16388,16834
5ea728146307ba36aa1e0041,51025,05000US51025,Brunswick County,"Brunswick County, Virginia",16665,8892,7773
5ea728146307ba36aa1e0042,51027,05000US51027,Buchanan County,"Buchanan County, Virginia",22138,11155,10983
5ea728146307ba36aa1e0043,51029,05000US51029,Buckingham County,"Buckingham County, Virginia",17004,9422,7582
5ea728146307ba36aa1e0044,51031,05000US51031,Campbell County,"Campbell County, Virginia",55170,26736,28434
5ea728146307ba36aa1e0045,51033,05000US51033,Caroline County,"Caroline County, Virginia",30184,15138,15046
5ea728146307ba36aa1e0046,51035,05000US51035,Carroll County,"Carroll County, Virginia",29738,14963,14775
5ea728146307ba36aa1e0047,51036,05000US51036,Charles City County,"Charles City County, Virginia",6995,3441,3554
5ea728146307ba36aa1e0048,51037,05000US51037,Charlotte County,"Charlotte County, Virginia",12095,5981,6114
5ea728146307ba36aa1e0049,51041,05000US51041,Chesterfield County,"Chesterfield County, Virginia",339447,163534,175913
5ea728146307ba36aa1e004a,51043,05000US51043,Clarke County,"Clarke County, Virginia",14365,7333,7032
5ea728146307ba36aa1e004b,51045,05000US51045,Craig County,"Craig County, Virginia",5113,2501,2612
5ea728146307ba36aa1e004c,51047,05000US51047,Culpeper County,"Culpeper County, Virginia",50450,25249,25201
5ea728146307ba36aa1e004d,51049,05000US51049,Cumberland County,"Cumberland County, Virginia",9786,4830,4956
5ea728146307ba36aa1e004e,51051,05000US51051,Dickenson County,"Dickenson County, Virginia",14960,7585,7375
5ea728146307ba36aa1e004f,51053,05000US51053,Dinwiddie County,"Dinwiddie County, Virginia",28308,14010,14298
5ea728146307ba36aa1e0050,51057,05000US51057,Essex County,"Essex County, Virginia",11036,4962,6074
5ea728146307ba36aa1e0051,51059,05000US51059,Fairfax County,"Fairfax County, Virginia",1143529,566646,576883
5ea728146307ba36aa1e0052,51061,05000US51061,Fauquier County,"Fauquier County, Virginia",69115,34283,34832
5ea728146307ba36aa1e0053,51063,05000US51063,Floyd County,"Floyd County, Virginia",15666,7824,7842
5ea728146307ba36aa1e0054,51065,05000US51065,Fluvanna County,"Fluvanna County, Virginia",26282,12005,14277
5ea728146307ba36aa1e0055,51067,05000US51067,Franklin County,"Franklin County, Virginia",56233,27532,28701
5ea728146307ba36aa1e0056,51069,05000US51069,Frederick County,"Frederick County, Virginia",85153,42405,42748
5ea728146307ba36aa1e0057,51071,05000US51071,Giles County,"Giles County, Virginia",16814,8252,8562
5ea728146307ba36aa1e0058,51073,05000US51073,Gloucester County,"Gloucester County, Virginia",37161,18328,18833
5ea728146307ba36aa1e0059,51075,05000US51075,Goochland County,"Goochland County, Virginia",22482,11129,11353
5ea728146307ba36aa1e005a,51077,05000US51077,Grayson County,"Grayson County, Virginia",15811,7995,7816
5ea728146307ba36aa1e005b,51079,05000US51079,Greene County,"Greene County, Virginia",19410,9450,9960
5ea728146307ba36aa1e005c,51081,05000US51081,Greensville County,"Greensville County, Virginia",11659,7336,4323
5ea728146307ba36aa1e005d,51083,05000US51083,Halifax County,"Halifax County, Virginia",34779,16638,18141
5ea728146307ba36aa1e005e,51085,05000US51085,Hanover County,"Hanover County, Virginia",104449,51222,53227
5ea728146307ba36aa1e005f,51087,05000US51087,Henrico County,"Henrico County, Virginia",325642,154247,171395
5ea728146307ba36aa1e0060,51089,05000US51089,Henry County,"Henry County, Virginia",51588,24866,26722
5ea728146307ba36aa1e0061,51091,05000US51091,Highland County,"Highland County, Virginia",2214,1043,1171
5ea728146307ba36aa1e0062,51093,05000US51093,Isle of Wight County,"Isle of Wight County, Virginia",36372,17744,18628
5ea728146307ba36aa1e0063,51095,05000US51095,James City County,"James City County, Virginia",74153,35884,38269
5ea728146307ba36aa1e0064,51097,05000US51097,King and Queen County,"King and Queen County, Virginia",7052,3538,3514
5ea728146307ba36aa1e0065,51099,05000US51099,King George County,"King George County, Virginia",25890,12996,12894
5ea728146307ba36aa1e0066,51101,05000US51101,King William County,"King William County, Virginia",16497,8113,8384
5ea728146307ba36aa1e0067,51103,05000US51103,Lancaster County,"Lancaster County, Virginia",10804,5108,5696
5ea728146307ba36aa1e0068,51105,05000US51105,Lee County,"Lee County, Virginia",24134,12608,11526
5ea728146307ba36aa1e0069,51107,05000US51107,Loudoun County,"Loudoun County, Virginia",385143,190737,194406
5ea728146307ba36aa1e006a,51109,05000US51109,Louisa County,"Louisa County, Virginia",35380,17376,18004
5ea728146307ba36aa1e006b,51111,05000US51111,Lunenburg County,"Lunenburg County, Virginia",12278,6261,6017
5ea728146307ba36aa1e006c,51113,05000US51113,Madison County,"Madison County, Virginia",13139,6350,6789
5ea728146307ba36aa1e006d,51115,05000US51115,Mathews County,"Mathews County, Virginia",8796,4292,4504
5ea728146307ba36aa1e006e,51117,05000US51117,Mecklenburg County,"Mecklenburg County, Virginia",30847,14909,15938
5ea728146307ba36aa1e006f,51119,05000US51119,Middlesex County,"Middlesex County, Virginia",10700,5182,5518
5ea728146307ba36aa1e0070,51121,05000US51121,Montgomery County,"Montgomery County, Virginia",97997,50738,47259
5ea728146307ba36aa1e0071,51125,05000US51125,Nelson County,"Nelson County, Virginia",14812,7198,7614
5ea728146307ba36aa1e0072,51127,05000US51127,New Kent County,"New Kent County, Virginia",21103,10603,10500
5ea728146307ba36aa1e0073,51131,05000US51131,Northampton County,"Northampton County, Virginia",11957,5699,6258
5ea728146307ba36aa1e0074,51133,05000US51133,Northumberland County,"Northumberland County, Virginia",12223,5967,6256
5ea728146307ba36aa1e0075,51135,05000US51135,Nottoway County,"Nottoway County, Virginia",15500,8403,7097
5ea728146307ba36aa1e0076,51137,05000US51137,Orange County,"Orange County, Virginia",35612,17418,18194
5ea728146307ba36aa1e0077,51139,05000US51139,Page County,"Page County, Virginia",23749,11675,12074
5ea728146307ba36aa1e0078,51141,05000US51141,Patrick County,"Patrick County, Virginia",17859,8896,8963
5ea728146307ba36aa1e0079,51143,05000US51143,Pittsylvania County,"Pittsylvania County, Virginia",61676,30241,31435
5ea728146307ba36aa1e007a,51145,05000US51145,Powhatan County,"Powhatan County, Virginia",28574,15249,13325
5ea728146307ba36aa1e007b,51147,05000US51147,Prince Edward County,"Prince Edward County, Virginia",22956,11493,11463
5ea728146307ba36aa1e007c,51149,05000US51149,Prince George County,"Prince George County, Virginia",37894,20612,17282
5ea728146307ba36aa1e007d,51153,05000US51153,Prince William County,"Prince William County, Virginia",456749,227951,228798
5ea728146307ba36aa1e007e,51155,05000US51155,Pulaski County,"Pulaski County, Virginia",34234,17138,17096
5ea728146307ba36aa1e007f,51157,05000US51157,Rappahannock County,"Rappahannock County, Virginia",7332,3630,3702
5ea728146307ba36aa1e0080,51159,05000US51159,Richmond County,"Richmond County, Virginia",8878,4928,3950
5ea728146307ba36aa1e0081,51161,05000US51161,Roanoke County,"Roanoke County, Virginia",93583,44850,48733
5ea728146307ba36aa1e0082,51163,05000US51163,Rockbridge County,"Rockbridge County, Virginia",22509,11185,11324
5ea728146307ba36aa1e0083,51165,05000US51165,Rockingham County,"Rockingham County, Virginia",79444,38910,40534
5ea728146307ba36aa1e0084,51167,05000US51167,Russell County,"Russell County, Virginia",27408,13371,14037
5ea728146307ba36aa1e0085,51169,05000US51169,Scott County,"Scott County, Virginia",22009,11089,10920
5ea728146307ba36aa1e0086,51171,05000US51171,Shenandoah County,"Shenandoah County, Virginia",43045,21044,22001
5ea728146307ba36aa1e0087,51173,05000US51173,Smyth County,"Smyth County, Virginia",31059,15301,15758
5ea728146307ba36aa1e0088,51175,05000US51175,Southampton County,"Southampton County, Virginia",17939,9345,8594
5ea728146307ba36aa1e0089,51177,05000US51177,Spotsylvania County,"Spotsylvania County, Virginia",131412,64570,66842
5ea728146307ba36aa1e008a,51179,05000US51179,Stafford County,"Stafford County, Virginia",144012,72540,71472
5ea728146307ba36aa1e008b,51181,05000US51181,Surry County,"Surry County, Virginia",6600,3203,3397
5ea728146307ba36aa1e008c,51183,05000US51183,Sussex County,"Sussex County, Virginia",11486,6831,4655
5ea728146307ba36aa1e008d,51185,05000US51185,Tazewell County,"Tazewell County, Virginia",42080,20841,21239
5ea728146307ba36aa1e008e,51187,05000US51187,Warren County,"Warren County, Virginia",39449,19666,19783
5ea728146307ba36aa1e008f,51191,05000US51191,Washington County,"Washington County, Virginia",54406,26851,27555
5ea728146307ba36aa1e0090,51193,05000US51193,Westmoreland County,"Westmoreland County, Virginia",17638,8629,9009
5ea728146307ba36aa1e0091,51195,05000US51195,Wise County,"Wise County, Virginia",39025,20490,18535
5ea728146307ba36aa1e0092,51197,05000US51197,Wythe County,"Wythe County, Virginia",28940,14112,14828
5ea728146307ba36aa1e0093,51199,05000US51199,York County,"York County, Virginia",67587,33231,34356
5ea728146307ba36aa1e0094,51510,05000US51510,Alexandria city,"Alexandria city, Virginia",156505,75346,81159
5ea728146307ba36aa1e0095,51520,05000US51520,Bristol city,"Bristol city, Virginia",16843,8004,8839
5ea728146307ba36aa1e0096,51530,05000US51530,Buena Vista city,"Buena Vista city, Virginia",6399,2845,3554
5ea728146307ba36aa1e0097,51540,05000US51540,Charlottesville city,"Charlottesville city, Virginia",47042,22830,24212
5ea728146307ba36aa1e0098,51550,05000US51550,Chesapeake city,"Chesapeake city, Virginia",237820,116188,121632
5ea728146307ba36aa1e0099,51570,05000US51570,Colonial Heights city,"Colonial Heights city, Virginia",17593,8053,9540
5ea728146307ba36aa1e009a,51580,05000US51580,Covington city,"Covington city, Virginia",5582,2742,2840
5ea728146307ba36aa1e009b,51590,05000US51590,Danville city,"Danville city, Virginia",41512,19041,22471
5ea728146307ba36aa1e009c,51595,05000US51595,Emporia city,"Emporia city, Virginia",5381,2408,2973
5ea728146307ba36aa1e009d,51600,05000US51600,Fairfax city,"Fairfax city, Virginia",23865,11801,12064
5ea728146307ba36aa1e009e,51610,05000US51610,Falls Church city,"Falls Church city, Virginia",14067,7017,7050
5ea728146307ba36aa1e009f,51620,05000US51620,Franklin city,"Franklin city, Virginia",8211,3611,4600
5ea728146307ba36aa1e00a0,51630,05000US51630,Fredericksburg city,"Fredericksburg city, Virginia",28469,13064,15405
5ea728146307ba36aa1e00a1,51640,05000US51640,Galax city,"Galax city, Virginia",6638,3174,3464
5ea728146307ba36aa1e00a2,51650,05000US51650,Hampton city,"Hampton city, Virginia",135583,65275,70308
5ea728146307ba36aa1e00a3,51660,05000US51660,Harrisonburg city,"Harrisonburg city, Virginia",53391,25580,27811
5ea728146307ba36aa1e00a4,51670,05000US51670,Hopewell city,"Hopewell city, Virginia",22408,10375,12033
5ea728146307ba36aa1e00a5,51678,05000US51678,Lexington city,"Lexington city, Virginia",7110,3910,3200
5ea728146307ba36aa1e00a6,51680,05000US51680,Lynchburg city,"Lynchburg city, Virginia",80131,37515,42616
5ea728146307ba36aa1e00a7,51683,05000US51683,Manassas city,"Manassas city, Virginia",41457,20775,20682
5ea728146307ba36aa1e00a8,51685,05000US51685,Manassas Park city,"Manassas Park city, Virginia",16423,8568,7855
5ea728146307ba36aa1e00a9,51690,05000US51690,Martinsville city,"Martinsville city, Virginia",13101,5867,7234
5ea728146307ba36aa1e00aa,51700,05000US51700,Newport News city,"Newport News city, Virginia",180145,87221,92924
5ea728146307ba36aa1e00ab,51710,05000US51710,Norfolk city,"Norfolk city, Virginia",245592,128293,117299
5ea728146307ba36aa1e00ac,51720,05000US51720,Norton city,"Norton city, Virginia",3990,1792,2198
5ea728146307ba36aa1e00ad,51730,05000US51730,Petersburg city,"Petersburg city, Virginia",31827,14651,17176
5ea728146307ba36aa1e00ae,51735,05000US51735,Poquoson city,"Poquoson city, Virginia",12039,5856,6183
5ea728146307ba36aa1e00af,51740,05000US51740,Portsmouth city,"Portsmouth city, Virginia",95311,45919,49392
5ea728146307ba36aa1e00b0,51750,05000US51750,Radford city,"Radford city, Virginia",17630,8425,9205
5ea728146307ba36aa1e00b1,51760,05000US51760,Richmond city,"Richmond city, Virginia",223787,106222,117565
5ea728146307ba36aa1e00b2,51770,05000US51770,Roanoke city,"Roanoke city, Virginia",99621,47775,51846
5ea728146307ba36aa1e00b3,51775,05000US51775,Salem city,"Salem city, Virginia",25519,11902,13617
5ea728146307ba36aa1e00b4,51790,05000US51790,Staunton city,"Staunton city, Virginia",24452,11198,13254
5ea728146307ba36aa1e00b5,51800,05000US51800,Suffolk city,"Suffolk city, Virginia",89160,43085,46075
5ea728146307ba36aa1e00b6,51810,05000US51810,Virginia Beach city,"Virginia Beach city, Virginia",450135,221285,228850
5ea728146307ba36aa1e00b7,51820,05000US51820,Waynesboro city,"Waynesboro city, Virginia",21926,10660,11266
5ea728146307ba36aa1e00b8,51830,05000US51830,Williamsburg city,"Williamsburg city, Virginia",14788,6727,8061
5ea728146307ba36aa1e00b9,51840,05000US51840,Winchester city,"Winchester city, Virginia",27789,13573,14216
5ea728146307ba36aa1e00ba,53001,05000US53001,Adams County,"Adams County, Washington",19452,9844,9608
5ea728146307ba36aa1e00bb,53003,05000US53003,Asotin County,"Asotin County, Washington",22337,10721,11616
5ea728146307ba36aa1e00bc,53005,05000US53005,Benton County,"Benton County, Washington",194168,97139,97029
5ea728146307ba36aa1e00bd,53007,05000US53007,Chelan County,"Chelan County, Washington",75757,37764,37993
5ea728146307ba36aa1e00be,53009,05000US53009,Clallam County,"Clallam County, Washington",74487,36857,37630
5ea728146307ba36aa1e00bf,53011,05000US53011,Clark County,"Clark County, Washington",465384,230092,235292
5ea728146307ba36aa1e00c0,53013,05000US53013,Columbia County,"Columbia County, Washington",4001,1930,2071
5ea728146307ba36aa1e00c1,53015,05000US53015,Cowlitz County,"Cowlitz County, Washington",105112,51937,53175
5ea728146307ba36aa1e00c2,53017,05000US53017,Douglas County,"Douglas County, Washington",41371,20821,20550
5ea728146307ba36aa1e00c3,53019,05000US53019,Ferry County,"Ferry County, Washington",7576,3884,3692
5ea728146307ba36aa1e00c4,53021,05000US53021,Franklin County,"Franklin County, Washington",90660,47145,43515
5ea728146307ba36aa1e00c5,53023,05000US53023,Garfield County,"Garfield County, Washington",2224,1099,1125
5ea728146307ba36aa1e00c6,53025,05000US53025,Grant County,"Grant County, Washington",94860,48099,46761
5ea728146307ba36aa1e00c7,53027,05000US53027,Grays Harbor County,"Grays Harbor County, Washington",71967,36981,34986
5ea728146307ba36aa1e00c8,53029,05000US53029,Island County,"Island County, Washington",81636,40781,40855
5ea728146307ba36aa1e00c9,53031,05000US53031,Jefferson County,"Jefferson County, Washington",30856,15354,15502
5ea728146307ba36aa1e00ca,53033,05000US53033,King County,"King County, Washington",2163257,1082940,1080317
5ea728146307ba36aa1e00cb,53035,05000US53035,Kitsap County,"Kitsap County, Washington",262475,134094,128381
5ea728146307ba36aa1e00cc,53037,05000US53037,Kittitas County,"Kittitas County, Washington",44825,22555,22270
5ea728146307ba36aa1e00cd,53039,05000US53039,Klickitat County,"Klickitat County, Washington",21396,10751,10645
5ea728146307ba36aa1e00ce,53041,05000US53041,Lewis County,"Lewis County, Washington",76947,38509,38438
5ea728146307ba36aa1e00cf,53043,05000US53043,Lincoln County,"Lincoln County, Washington",10435,5311,5124
5ea728146307ba36aa1e00d0,53045,05000US53045,Mason County,"Mason County, Washington",62627,32413,30214
5ea728146307ba36aa1e00d1,53047,05000US53047,Okanogan County,"Okanogan County, Washington",41638,21061,20577
5ea728146307ba36aa1e00d2,53049,05000US53049,Pacific County,"Pacific County, Washington",21281,10640,10641
5ea728146307ba36aa1e00d3,53051,05000US53051,Pend Oreille County,"Pend Oreille County, Washington",13219,6694,6525
5ea728146307ba36aa1e00d4,53053,05000US53053,Pierce County,"Pierce County, Washington",859840,427571,432269
5ea728146307ba36aa1e00d5,53055,05000US53055,San Juan County,"San Juan County, Washington",16473,7956,8517
5ea728146307ba36aa1e00d6,53057,05000US53057,Skagit County,"Skagit County, Washington",123907,61376,62531
5ea728146307ba36aa1e00d7,53059,05000US53059,Skamania County,"Skamania County, Washington",11620,5861,5759
5ea728146307ba36aa1e00d8,53061,05000US53061,Snohomish County,"Snohomish County, Washington",786620,394526,392094
5ea728146307ba36aa1e00d9,53063,05000US53063,Spokane County,"Spokane County, Washington",497875,246906,250969
5ea728146307ba36aa1e00da,53065,05000US53065,Stevens County,"Stevens County, Washington",44214,21944,22270
5ea728146307ba36aa1e00db,53067,05000US53067,Thurston County,"Thurston County, Washington",274684,134402,140282
5ea728146307ba36aa1e00dc,53069,05000US53069,Wahkiakum County,"Wahkiakum County, Washington",4189,2000,2189
5ea728146307ba36aa1e00dd,53071,05000US53071,Walla Walla County,"Walla Walla County, Washington",60236,30830,29406
5ea728146307ba36aa1e00de,53073,05000US53073,Whatcom County,"Whatcom County, Washington",216812,107228,109584
5ea728146307ba36aa1e00df,53075,05000US53075,Whitman County,"Whitman County, Washington",48593,24749,23844
5ea728146307ba36aa1e00e0,53077,05000US53077,Yakima County,"Yakima County, Washington",249325,124900,124425
5ea728146307ba36aa1e00e1,54001,05000US54001,Barbour County,"Barbour County, West Virginia",16730,8143,8587
5ea728146307ba36aa1e00e2,54003,05000US54003,Berkeley County,"Berkeley County, West Virginia",113495,56013,57482
5ea728146307ba36aa1e00e3,54005,05000US54005,Boone County,"Boone County, West Virginia",22817,11350,11467
5ea728146307ba36aa1e00e4,54007,05000US54007,Braxton County,"Braxton County, West Virginia",14282,7125,7157
5ea728146307ba36aa1e00e5,54009,05000US54009,Brooke County,"Brooke County, West Virginia",22772,11171,11601
5ea728146307ba36aa1e00e6,54011,05000US54011,Cabell County,"Cabell County, West Virginia",95318,46739,48579
5ea728146307ba36aa1e00e7,54013,05000US54013,Calhoun County,"Calhoun County, West Virginia",7396,3642,3754
5ea728146307ba36aa1e00e8,54015,05000US54015,Clay County,"Clay County, West Virginia",8785,4388,4397
5ea728146307ba36aa1e00e9,54017,05000US54017,Doddridge County,"Doddridge County, West Virginia",8536,4692,3844
5ea728146307ba36aa1e00ea,54019,05000US54019,Fayette County,"Fayette County, West Virginia",44126,22099,22027
5ea728146307ba36aa1e00eb,54021,05000US54021,Gilmer County,"Gilmer County, West Virginia",8205,4733,3472
5ea728146307ba36aa1e00ec,54023,05000US54023,Grant County,"Grant County, West Virginia",11641,5813,5828
5ea728146307ba36aa1e00ed,54025,05000US54025,Greenbrier County,"Greenbrier County, West Virginia",35347,17203,18144
5ea728146307ba36aa1e00ee,54027,05000US54027,Hampshire County,"Hampshire County, West Virginia",23363,11980,11383
5ea728146307ba36aa1e00ef,54029,05000US54029,Hancock County,"Hancock County, West Virginia",29680,14376,15304
5ea728146307ba36aa1e00f0,54031,05000US54031,Hardy County,"Hardy County, West Virginia",13842,7112,6730
5ea728146307ba36aa1e00f1,54033,05000US54033,Harrison County,"Harrison County, West Virginia",68209,33301,34908
5ea728146307ba36aa1e00f2,54035,05000US54035,Jackson County,"Jackson County, West Virginia",29018,14417,14601
5ea728146307ba36aa1e00f3,54037,05000US54037,Jefferson County,"Jefferson County, West Virginia",56179,27743,28436
5ea728146307ba36aa1e00f4,54039,05000US54039,Kanawha County,"Kanawha County, West Virginia",185710,89483,96227
5ea728146307ba36aa1e00f5,54041,05000US54041,Lewis County,"Lewis County, West Virginia",16276,8202,8074
5ea728146307ba36aa1e00f6,54043,05000US54043,Lincoln County,"Lincoln County, West Virginia",21078,10539,10539
5ea728146307ba36aa1e00f7,54045,05000US54045,Logan County,"Logan County, West Virginia",33801,16672,17129
5ea728146307ba36aa1e00f8,54047,05000US54047,McDowell County,"McDowell County, West Virginia",19217,9837,9380
5ea728146307ba36aa1e00f9,54049,05000US54049,Marion County,"Marion County, West Virginia",56497,27819,28678
5ea728146307ba36aa1e00fa,54051,05000US54051,Marshall County,"Marshall County, West Virginia",31645,15730,15915
5ea728146307ba36aa1e00fb,54053,05000US54053,Mason County,"Mason County, West Virginia",26939,13026,13913
5ea728146307ba36aa1e00fc,54055,05000US54055,Mercer County,"Mercer County, West Virginia",60486,28728,31758
5ea728146307ba36aa1e00fd,54057,05000US54057,Mineral County,"Mineral County, West Virginia",27278,13649,13629
5ea728146307ba36aa1e00fe,54059,05000US54059,Mingo County,"Mingo County, West Virginia",24741,12024,12717
5ea728146307ba36aa1e00ff,54061,05000US54061,Monongalia County,"Monongalia County, West Virginia",105252,54501,50751
5ea728146307ba36aa1e0100,54063,05000US54063,Monroe County,"Monroe County, West Virginia",13467,6683,6784
5ea728146307ba36aa1e0101,54065,05000US54065,Morgan County,"Morgan County, West Virginia",17624,8763,8861
5ea728146307ba36aa1e0102,54067,05000US54067,Nicholas County,"Nicholas County, West Virginia",25324,12420,12904
5ea728146307ba36aa1e0103,54069,05000US54069,Ohio County,"Ohio County, West Virginia",42547,20465,22082
5ea728146307ba36aa1e0104,54071,05000US54071,Pendleton County,"Pendleton County, West Virginia",7056,3622,3434
5ea728146307ba36aa1e0105,54073,05000US54073,Pleasants County,"Pleasants County, West Virginia",7507,4064,3443
5ea728146307ba36aa1e0106,54075,05000US54075,Pocahontas County,"Pocahontas County, West Virginia",8531,4377,4154
5ea728146307ba36aa1e0107,54077,05000US54077,Preston County,"Preston County, West Virginia",33837,17408,16429
5ea728146307ba36aa1e0108,54079,05000US54079,Putnam County,"Putnam County, West Virginia",56652,27862,28790
5ea728146307ba36aa1e0109,54081,05000US54081,Raleigh County,"Raleigh County, West Virginia",76232,38188,38044
5ea728146307ba36aa1e010a,54083,05000US54083,Randolph County,"Randolph County, West Virginia",29065,14861,14204
5ea728146307ba36aa1e010b,54085,05000US54085,Ritchie County,"Ritchie County, West Virginia",9932,4965,4967
5ea728146307ba36aa1e010c,54087,05000US54087,Roane County,"Roane County, West Virginia",14205,7034,7171
5ea728146307ba36aa1e010d,54089,05000US54089,Summers County,"Summers County, West Virginia",13018,5994,7024
5ea728146307ba36aa1e010e,54091,05000US54091,Taylor County,"Taylor County, West Virginia",16951,8580,8371
5ea728146307ba36aa1e010f,54093,05000US54093,Tucker County,"Tucker County, West Virginia",7027,3540,3487
5ea728146307ba36aa1e0110,54095,05000US54095,Tyler County,"Tyler County, West Virginia",8909,4437,4472
5ea728146307ba36aa1e0111,54097,05000US54097,Upshur County,"Upshur County, West Virginia",24605,12200,12405
5ea728146307ba36aa1e0112,54099,05000US54099,Wayne County,"Wayne County, West Virginia",40708,19835,20873
5ea728146307ba36aa1e0113,54101,05000US54101,Webster County,"Webster County, West Virginia",8518,4199,4319
5ea728146307ba36aa1e0114,54103,05000US54103,Wetzel County,"Wetzel County, West Virginia",15614,7586,8028
5ea728146307ba36aa1e0115,54105,05000US54105,Wirt County,"Wirt County, West Virginia",5797,2922,2875
5ea728146307ba36aa1e0116,54107,05000US54107,Wood County,"Wood County, West Virginia",85556,41246,44310
5ea728146307ba36aa1e0117,54109,05000US54109,Wyoming County,"Wyoming County, West Virginia",21711,10695,11016
5ea728146307ba36aa1e0118,55001,05000US55001,Adams County,"Adams County, Wisconsin",20073,10783,9290
5ea728146307ba36aa1e0119,55003,05000US55003,Ashland County,"Ashland County, Wisconsin",15712,7930,7782
5ea728146307ba36aa1e011a,55005,05000US55005,Barron County,"Barron County, Wisconsin",45252,22616,22636
5ea728146307ba36aa1e011b,55007,05000US55007,Bayfield County,"Bayfield County, Wisconsin",14992,7632,7360
5ea728146307ba36aa1e011c,55009,05000US55009,Brown County,"Brown County, Wisconsin",259786,128824,130962
5ea728146307ba36aa1e011d,55011,05000US55011,Buffalo County,"Buffalo County, Wisconsin",13167,6658,6509
5ea728146307ba36aa1e011e,55013,05000US55013,Burnett County,"Burnett County, Wisconsin",15258,7832,7426
5ea728146307ba36aa1e011f,55015,05000US55015,Calumet County,"Calumet County, Wisconsin",49807,24954,24853
5ea728146307ba36aa1e0120,55017,05000US55017,Chippewa County,"Chippewa County, Wisconsin",63635,33078,30557
5ea728146307ba36aa1e0121,55019,05000US55019,Clark County,"Clark County, Wisconsin",34491,17478,17013
5ea728146307ba36aa1e0122,55021,05000US55021,Columbia County,"Columbia County, Wisconsin",56954,29047,27907
5ea728146307ba36aa1e0123,55023,05000US55023,Crawford County,"Crawford County, Wisconsin",16288,8490,7798
5ea728146307ba36aa1e0124,55025,05000US55025,Dane County,"Dane County, Wisconsin",529843,263322,266521
5ea728146307ba36aa1e0125,55027,05000US55027,Dodge County,"Dodge County, Wisconsin",87776,45777,41999
5ea728146307ba36aa1e0126,55029,05000US55029,Door County,"Door County, Wisconsin",27439,13535,13904
5ea728146307ba36aa1e0127,55031,05000US55031,Douglas County,"Douglas County, Wisconsin",43402,21757,21645
5ea728146307ba36aa1e0128,55033,05000US55033,Dunn County,"Dunn County, Wisconsin",44498,22372,22126
5ea728146307ba36aa1e0129,55035,05000US55035,Eau Claire County,"Eau Claire County, Wisconsin",102991,50874,52117
5ea728146307ba36aa1e012a,55037,05000US55037,Florence County,"Florence County, Wisconsin",4337,2275,2062
5ea728146307ba36aa1e012b,55039,05000US55039,Fond du Lac County,"Fond du Lac County, Wisconsin",102315,50302,52013
5ea728146307ba36aa1e012c,55041,05000US55041,Forest County,"Forest County, Wisconsin",9018,4541,4477
5ea728146307ba36aa1e012d,55043,05000US55043,Grant County,"Grant County, Wisconsin",51828,26920,24908
5ea728146307ba36aa1e012e,55045,05000US55045,Green County,"Green County, Wisconsin",36864,18230,18634
5ea728146307ba36aa1e012f,55047,05000US55047,Green Lake County,"Green Lake County, Wisconsin",18757,9437,9320
5ea728146307ba36aa1e0130,55049,05000US55049,Iowa County,"Iowa County, Wisconsin",23620,11892,11728
5ea728146307ba36aa1e0131,55051,05000US55051,Iron County,"Iron County, Wisconsin",5715,2915,2800
5ea728146307ba36aa1e0132,55053,05000US55053,Jackson County,"Jackson County, Wisconsin",20506,10955,9551
5ea728146307ba36aa1e0133,55055,05000US55055,Jefferson County,"Jefferson County, Wisconsin",84652,42343,42309
5ea728146307ba36aa1e0134,55057,05000US55057,Juneau County,"Juneau County, Wisconsin",26419,14067,12352
5ea728146307ba36aa1e0135,55059,05000US55059,Kenosha County,"Kenosha County, Wisconsin",168330,83312,85018
5ea728146307ba36aa1e0136,55061,05000US55061,Kewaunee County,"Kewaunee County, Wisconsin",20360,10279,10081
5ea728146307ba36aa1e0137,55063,05000US55063,La Crosse County,"La Crosse County, Wisconsin",117850,57361,60489
5ea728146307ba36aa1e0138,55065,05000US55065,Lafayette County,"Lafayette County, Wisconsin",16735,8443,8292
5ea728146307ba36aa1e0139,55067,05000US55067,Langlade County,"Langlade County, Wisconsin",19164,9721,9443
5ea728146307ba36aa1e013a,55069,05000US55069,Lincoln County,"Lincoln County, Wisconsin",27848,13999,13849
5ea728146307ba36aa1e013b,55071,05000US55071,Manitowoc County,"Manitowoc County, Wisconsin",79407,39451,39956
5ea728146307ba36aa1e013c,55073,05000US55073,Marathon County,"Marathon County, Wisconsin",135264,67976,67288
5ea728146307ba36aa1e013d,55075,05000US55075,Marinette County,"Marinette County, Wisconsin",40537,20375,20162
5ea728146307ba36aa1e013e,55077,05000US55077,Marquette County,"Marquette County, Wisconsin",15207,7746,7461
5ea728146307ba36aa1e013f,55078,05000US55078,Menominee County,"Menominee County, Wisconsin",4579,2324,2255
5ea728146307ba36aa1e0140,55079,05000US55079,Milwaukee County,"Milwaukee County, Wisconsin",954209,461670,492539
5ea728146307ba36aa1e0141,55081,05000US55081,Monroe County,"Monroe County, Wisconsin",45502,23019,22483
5ea728146307ba36aa1e0142,55083,05000US55083,Oconto County,"Oconto County, Wisconsin",37556,19187,18369
5ea728146307ba36aa1e0143,55085,05000US55085,Oneida County,"Oneida County, Wisconsin",35345,17724,17621
5ea728146307ba36aa1e0144,55087,05000US55087,Outagamie County,"Outagamie County, Wisconsin",184754,92241,92513
5ea728146307ba36aa1e0145,55089,05000US55089,Ozaukee County,"Ozaukee County, Wisconsin",88284,43342,44942
5ea728146307ba36aa1e0146,55091,05000US55091,Pepin County,"Pepin County, Wisconsin",7262,3696,3566
5ea728146307ba36aa1e0147,55093,05000US55093,Pierce County,"Pierce County, Wisconsin",41603,20641,20962
5ea728146307ba36aa1e0148,55095,05000US55095,Polk County,"Polk County, Wisconsin",43349,21842,21507
5ea728146307ba36aa1e0149,55097,05000US55097,Portage County,"Portage County, Wisconsin",70599,35508,35091
5ea728146307ba36aa1e014a,55099,05000US55099,Price County,"Price County, Wisconsin",13490,6813,6677
5ea728146307ba36aa1e014b,55101,05000US55101,Racine County,"Racine County, Wisconsin",195398,96702,98696
5ea728146307ba36aa1e014c,55103,05000US55103,Richland County,"Richland County, Wisconsin",17539,8834,8705
5ea728146307ba36aa1e014d,55105,05000US55105,Rock County,"Rock County, Wisconsin",161769,79654,82115
5ea728146307ba36aa1e014e,55107,05000US55107,Rusk County,"Rusk County, Wisconsin",14183,7109,7074
5ea728146307ba36aa1e014f,55109,05000US55109,St. Croix County,"St. Croix County, Wisconsin",87917,43899,44018
5ea728146307ba36aa1e0150,55111,05000US55111,Sauk County,"Sauk County, Wisconsin",63596,31747,31849
5ea728146307ba36aa1e0151,55113,05000US55113,Sawyer County,"Sawyer County, Wisconsin",16370,8339,8031
5ea728146307ba36aa1e0152,55115,05000US55115,Shawano County,"Shawano County, Wisconsin",41009,20521,20488
5ea728146307ba36aa1e0153,55117,05000US55117,Sheboygan County,"Sheboygan County, Wisconsin",115205,57922,57283
5ea728146307ba36aa1e0154,55119,05000US55119,Taylor County,"Taylor County, Wisconsin",20356,10385,9971
5ea728146307ba36aa1e0155,55121,05000US55121,Trempealeau County,"Trempealeau County, Wisconsin",29438,14932,14506
5ea728146307ba36aa1e0156,55123,05000US55123,Vernon County,"Vernon County, Wisconsin",30516,15302,15214
5ea728146307ba36aa1e0157,55125,05000US55125,Vilas County,"Vilas County, Wisconsin",21593,10931,10662
5ea728146307ba36aa1e0158,55127,05000US55127,Walworth County,"Walworth County, Wisconsin",103013,51374,51639
5ea728146307ba36aa1e0159,55129,05000US55129,Washburn County,"Washburn County, Wisconsin",15689,7771,7918
5ea728146307ba36aa1e015a,55131,05000US55131,Washington County,"Washington County, Wisconsin",134535,66754,67781
5ea728146307ba36aa1e015b,55133,05000US55133,Waukesha County,"Waukesha County, Wisconsin",398879,196103,202776
5ea728146307ba36aa1e015c,55135,05000US55135,Waupaca County,"Waupaca County, Wisconsin",51444,26297,25147
5ea728146307ba36aa1e015d,55137,05000US55137,Waushara County,"Waushara County, Wisconsin",24116,12641,11475
5ea728146307ba36aa1e015e,55139,05000US55139,Winnebago County,"Winnebago County, Wisconsin",169926,85597,84329
5ea728146307ba36aa1e015f,55141,05000US55141,Wood County,"Wood County, Wisconsin",73274,36056,37218
5ea728146307ba36aa1e0160,56001,05000US56001,Albany County,"Albany County, Wyoming",38102,19916,18186
5ea728146307ba36aa1e0161,56003,05000US56003,Big Horn County,"Big Horn County, Wyoming",11901,6033,5868
5ea728146307ba36aa1e0162,56005,05000US56005,Campbell County,"Campbell County, Wyoming",47708,24559,23149
5ea728146307ba36aa1e0163,56007,05000US56007,Carbon County,"Carbon County, Wyoming",15477,8332,7145
5ea728146307ba36aa1e0164,56009,05000US56009,Converse County,"Converse County, Wyoming",13997,7206,6791
5ea728146307ba36aa1e0165,56011,05000US56011,Crook County,"Crook County, Wyoming",7410,3730,3680
5ea728146307ba36aa1e0166,56013,05000US56013,Fremont County,"Fremont County, Wyoming",40076,20135,19941
5ea728146307ba36aa1e0167,56015,05000US56015,Goshen County,"Goshen County, Wyoming",13438,6948,6490
5ea728146307ba36aa1e0168,56017,05000US56017,Hot Springs County,"Hot Springs County, Wyoming",4680,2387,2293
5ea728146307ba36aa1e0169,56019,05000US56019,Johnson County,"Johnson County, Wyoming",8515,4477,4038
5ea728146307ba36aa1e016a,56021,05000US56021,Laramie County,"Laramie County, Wyoming",97692,49460,48232
5ea728146307ba36aa1e016b,56023,05000US56023,Lincoln County,"Lincoln County, Wyoming",19011,9695,9316
5ea728146307ba36aa1e016c,56025,05000US56025,Natrona County,"Natrona County, Wyoming",80610,40816,39794
5ea728146307ba36aa1e016d,56027,05000US56027,Niobrara County,"Niobrara County, Wyoming",2448,1088,1360
5ea728146307ba36aa1e016e,56029,05000US56029,Park County,"Park County, Wyoming",29121,14276,14845
5ea728146307ba36aa1e016f,56031,05000US56031,Platte County,"Platte County, Wyoming",8673,4499,4174
5ea728146307ba36aa1e0170,56033,05000US56033,Sheridan County,"Sheridan County, Wyoming",30012,14852,15160
5ea728146307ba36aa1e0171,56035,05000US56035,Sublette County,"Sublette County, Wyoming",9951,5367,4584
5ea728146307ba36aa1e0172,56037,05000US56037,Sweetwater County,"Sweetwater County, Wyoming",44117,22882,21235
5ea728146307ba36aa1e0173,56039,05000US56039,Teton County,"Teton County, Wyoming",23059,11911,11148
5ea728146307ba36aa1e0174,56041,05000US56041,Uinta County,"Uinta County, Wyoming",20609,10505,10104
5ea728146307ba36aa1e0175,56043,05000US56043,Washakie County,"Washakie County, Wyoming",8129,4137,3992
5ea728146307ba36aa1e0176,56045,05000US56045,Weston County,"Weston County, Wyoming",7100,3768,3332
5ea728146307ba36aa1e0177,72001,05000US72001,Adjuntas Municipio,"Adjuntas Municipio, Puerto Rico",18181,8862,9319
5ea728146307ba36aa1e0178,72003,05000US72003,Aguada Municipio,"Aguada Municipio, Puerto Rico",38643,18906,19737
5ea728146307ba36aa1e0179,72005,05000US72005,Aguadilla Municipio,"Aguadilla Municipio, Puerto Rico",54166,26308,27858
5ea728146307ba36aa1e017a,72007,05000US72007,Aguas Buenas Municipio,"Aguas Buenas Municipio, Puerto Rico",26275,12756,13519
5ea728146307ba36aa1e017b,72009,05000US72009,Aibonito Municipio,"Aibonito Municipio, Puerto Rico",23457,11263,12194
5ea728146307ba36aa1e017c,72011,05000US72011,A�asco Municipio,"A�asco Municipio, Puerto Rico",27368,13240,14128
5ea728146307ba36aa1e017d,72013,05000US72013,Arecibo Municipio,"Arecibo Municipio, Puerto Rico",87242,41785,45457
5ea728146307ba36aa1e017e,72015,05000US72015,Arroyo Municipio,"Arroyo Municipio, Puerto Rico",18111,8514,9597
5ea728146307ba36aa1e017f,72017,05000US72017,Barceloneta Municipio,"Barceloneta Municipio, Puerto Rico",24299,11541,12758
5ea728146307ba36aa1e0180,72019,05000US72019,Barranquitas Municipio,"Barranquitas Municipio, Puerto Rico",28755,14162,14593
5ea728146307ba36aa1e0181,72021,05000US72021,Bayam�n Municipio,"Bayam�n Municipio, Puerto Rico",182955,86408,96547
5ea728146307ba36aa1e0182,72023,05000US72023,Cabo Rojo Municipio,"Cabo Rojo Municipio, Puerto Rico",49005,23237,25768
5ea728146307ba36aa1e0183,72025,05000US72025,Caguas Municipio,"Caguas Municipio, Puerto Rico",131363,61168,70195
5ea728146307ba36aa1e0184,72027,05000US72027,Camuy Municipio,"Camuy Municipio, Puerto Rico",32222,15424,16798
5ea728146307ba36aa1e0185,72029,05000US72029,Can�vanas Municipio,"Can�vanas Municipio, Puerto Rico",46108,22224,23884
5ea728146307ba36aa1e0186,72031,05000US72031,Carolina Municipio,"Carolina Municipio, Puerto Rico",157453,72157,85296
5ea728146307ba36aa1e0187,72033,05000US72033,Cata�o Municipio,"Cata�o Municipio, Puerto Rico",24888,11764,13124
5ea728146307ba36aa1e0188,72035,05000US72035,Cayey Municipio,"Cayey Municipio, Puerto Rico",44530,21378,23152
5ea728146307ba36aa1e0189,72037,05000US72037,Ceiba Municipio,"Ceiba Municipio, Puerto Rico",11853,5660,6193
5ea728146307ba36aa1e018a,72039,05000US72039,Ciales Municipio,"Ciales Municipio, Puerto Rico",16912,8240,8672
5ea728146307ba36aa1e018b,72041,05000US72041,Cidra Municipio,"Cidra Municipio, Puerto Rico",40343,19560,20783
5ea728146307ba36aa1e018c,72043,05000US72043,Coamo Municipio,"Coamo Municipio, Puerto Rico",39265,19056,20209
5ea728146307ba36aa1e018d,72045,05000US72045,Comer�o Municipio,"Comer�o Municipio, Puerto Rico",19539,9692,9847
5ea728146307ba36aa1e018e,72047,05000US72047,Corozal Municipio,"Corozal Municipio, Puerto Rico",34165,16565,17600
5ea728146307ba36aa1e018f,72049,05000US72049,Culebra Municipio,"Culebra Municipio, Puerto Rico",1314,676,638
5ea728146307ba36aa1e0190,72051,05000US72051,Dorado Municipio,"Dorado Municipio, Puerto Rico",37208,17728,19480
5ea728146307ba36aa1e0191,72053,05000US72053,Fajardo Municipio,"Fajardo Municipio, Puerto Rico",32001,14948,17053
5ea728146307ba36aa1e0192,72054,05000US72054,Florida Municipio,"Florida Municipio, Puerto Rico",11910,5693,6217
5ea728146307ba36aa1e0193,72055,05000US72055,Gu�nica Municipio,"Gu�nica Municipio, Puerto Rico",16783,8091,8692
5ea728146307ba36aa1e0194,72057,05000US72057,Guayama Municipio,"Guayama Municipio, Puerto Rico",41706,20744,20962
5ea728146307ba36aa1e0195,72059,05000US72059,Guayanilla Municipio,"Guayanilla Municipio, Puerto Rico",19008,9076,9932
5ea728146307ba36aa1e0196,72061,05000US72061,Guaynabo Municipio,"Guaynabo Municipio, Puerto Rico",88663,41805,46858
5ea728146307ba36aa1e0197,72063,05000US72063,Gurabo Municipio,"Gurabo Municipio, Puerto Rico",46894,22173,24721
5ea728146307ba36aa1e0198,72065,05000US72065,Hatillo Municipio,"Hatillo Municipio, Puerto Rico",40390,19407,20983
5ea728146307ba36aa1e0199,72067,05000US72067,Hormigueros Municipio,"Hormigueros Municipio, Puerto Rico",16180,7461,8719
5ea728146307ba36aa1e019a,72069,05000US72069,Humacao Municipio,"Humacao Municipio, Puerto Rico",53466,25267,28199
5ea728146307ba36aa1e019b,72071,05000US72071,Isabela Municipio,"Isabela Municipio, Puerto Rico",42420,20629,21791
5ea728146307ba36aa1e019c,72073,05000US72073,Jayuya Municipio,"Jayuya Municipio, Puerto Rico",14906,7428,7478
5ea728146307ba36aa1e019d,72075,05000US72075,Juana D�az Municipio,"Juana D�az Municipio, Puerto Rico",46960,22378,24582
5ea728146307ba36aa1e019e,72077,05000US72077,Juncos Municipio,"Juncos Municipio, Puerto Rico",39128,18630,20498
5ea728146307ba36aa1e019f,72079,05000US72079,Lajas Municipio,"Lajas Municipio, Puerto Rico",23315,11355,11960
5ea728146307ba36aa1e01a0,72081,05000US72081,Lares Municipio,"Lares Municipio, Puerto Rico",26451,13026,13425
5ea728146307ba36aa1e01a1,72083,05000US72083,Las Mar�as Municipio,"Las Mar�as Municipio, Puerto Rico",8599,4147,4452
5ea728146307ba36aa1e01a2,72085,05000US72085,Las Piedras Municipio,"Las Piedras Municipio, Puerto Rico",37768,18163,19605
5ea728146307ba36aa1e01a3,72087,05000US72087,Lo�za Municipio,"Lo�za Municipio, Puerto Rico",26463,12337,14126
5ea728146307ba36aa1e01a4,72089,05000US72089,Luquillo Municipio,"Luquillo Municipio, Puerto Rico",18547,8705,9842
5ea728146307ba36aa1e01a5,72091,05000US72091,Manat� Municipio,"Manat� Municipio, Puerto Rico",39692,18720,20972
5ea728146307ba36aa1e01a6,72093,05000US72093,Maricao Municipio,"Maricao Municipio, Puerto Rico",6202,3069,3133
5ea728146307ba36aa1e01a7,72095,05000US72095,Maunabo Municipio,"Maunabo Municipio, Puerto Rico",11023,5411,5612
5ea728146307ba36aa1e01a8,72097,05000US72097,Mayag�ez Municipio,"Mayag�ez Municipio, Puerto Rico",77255,36902,40353
5ea728146307ba36aa1e01a9,72099,05000US72099,Moca Municipio,"Moca Municipio, Puerto Rico",36872,18012,18860
5ea728146307ba36aa1e01aa,72101,05000US72101,Morovis Municipio,"Morovis Municipio, Puerto Rico",31320,15537,15783
5ea728146307ba36aa1e01ab,72103,05000US72103,Naguabo Municipio,"Naguabo Municipio, Puerto Rico",26266,12332,13934
5ea728146307ba36aa1e01ac,72105,05000US72105,Naranjito Municipio,"Naranjito Municipio, Puerto Rico",28557,14039,14518
5ea728146307ba36aa1e01ad,72107,05000US72107,Orocovis Municipio,"Orocovis Municipio, Puerto Rico",21407,10725,10682
5ea728146307ba36aa1e01ae,72109,05000US72109,Patillas Municipio,"Patillas Municipio, Puerto Rico",17334,8481,8853
5ea728146307ba36aa1e01af,72111,05000US72111,Pe�uelas Municipio,"Pe�uelas Municipio, Puerto Rico",20984,10190,10794
5ea728146307ba36aa1e01b0,72113,05000US72113,Ponce Municipio,"Ponce Municipio, Puerto Rico",143926,69272,74654
5ea728146307ba36aa1e01b1,72115,05000US72115,Quebradillas Municipio,"Quebradillas Municipio, Puerto Rico",24036,11606,12430
5ea728146307ba36aa1e01b2,72117,05000US72117,Rinc�n Municipio,"Rinc�n Municipio, Puerto Rico",14269,6844,7425
5ea728146307ba36aa1e01b3,72119,05000US72119,R�o Grande Municipio,"R�o Grande Municipio, Puerto Rico",50550,24397,26153
5ea728146307ba36aa1e01b4,72121,05000US72121,Sabana Grande Municipio,"Sabana Grande Municipio, Puerto Rico",23054,10877,12177
5ea728146307ba36aa1e01b5,72123,05000US72123,Salinas Municipio,"Salinas Municipio, Puerto Rico",28633,13843,14790
5ea728146307ba36aa1e01b6,72125,05000US72125,San Germ�n Municipio,"San Germ�n Municipio, Puerto Rico",32114,15606,16508
5ea728146307ba36aa1e01b7,72127,05000US72127,San Juan Municipio,"San Juan Municipio, Puerto Rico",344606,157742,186864
5ea728146307ba36aa1e01b8,72129,05000US72129,San Lorenzo Municipio,"San Lorenzo Municipio, Puerto Rico",37873,18450,19423
5ea728146307ba36aa1e01b9,72131,05000US72131,San Sebasti�n Municipio,"San Sebasti�n Municipio, Puerto Rico",37964,18448,19516
5ea728146307ba36aa1e01ba,72133,05000US72133,Santa Isabel Municipio,"Santa Isabel Municipio, Puerto Rico",22066,10650,11416
5ea728146307ba36aa1e01bb,72135,05000US72135,Toa Alta Municipio,"Toa Alta Municipio, Puerto Rico",73405,35281,38124
5ea728146307ba36aa1e01bc,72137,05000US72137,Toa Baja Municipio,"Toa Baja Municipio, Puerto Rico",79726,37382,42344
5ea728146307ba36aa1e01bd,72139,05000US72139,Trujillo Alto Municipio,"Trujillo Alto Municipio, Puerto Rico",67780,31892,35888
5ea728146307ba36aa1e01be,72141,05000US72141,Utuado Municipio,"Utuado Municipio, Puerto Rico",29402,14279,15123
5ea728146307ba36aa1e01bf,72143,05000US72143,Vega Alta Municipio,"Vega Alta Municipio, Puerto Rico",37724,18044,19680
5ea728146307ba36aa1e01c0,72145,05000US72145,Vega Baja Municipio,"Vega Baja Municipio, Puerto Rico",53371,25580,27791
5ea728146307ba36aa1e01c1,72147,05000US72147,Vieques Municipio,"Vieques Municipio, Puerto Rico",8771,4332,4439
5ea728146307ba36aa1e01c2,72149,05000US72149,Villalba Municipio,"Villalba Municipio, Puerto Rico",22993,11169,11824
5ea728146307ba36aa1e01c3,72151,05000US72151,Yabucoa Municipio,"Yabucoa Municipio, Puerto Rico",34149,16541,17608
5ea728146307ba36aa1e01c4,72153,05000US72153,Yauco Municipio,"Yauco Municipio, Puerto Rico",36439,17475,18964
